new unique backpack ! combines vintage with modern ! URL1283 via @USER415	ADJ NOUN NOUN PUNCT X NOUN ADP NOUN PUNCT X ADP X
RT @USER767 : It 's been 3 years since the release of the music video of Burning Desire . URL637	X X PUNCT PRON AUX AUX NUM NOUN ADP DET NOUN ADP DET NOUN NOUN ADP NOUN NOUN PUNCT X
#openfollow for kpopers just retweet	NOUN ADP NOUN ADV VERB
RT @USER526 : empathy 4 Kesha .... the worst . smh smh .. \ud83d\udc94	X X PUNCT NOUN NUM NOUN PUNCT DET ADJ PUNCT INTJ INTJ PUNCT SYM
RT @USER2128 : do n't jump to conclusions . do n't take what the media says at face value . do your own research & stay informed . stop falling \u2026	X X PUNCT AUX PART VERB PART NOUN PUNCT AUX PART VERB PRON DET NOUN VERB ADP NOUN NOUN PUNCT VERB PRON ADJ NOUN CCONJ VERB NOUN PUNCT VERB X PUNCT
RT @USER445 : Spine - Chilling Stories of Real Life Cannibals , Horrible ! URL1310 URL1455	X X PUNCT NOUN PUNCT NOUN NOUN ADP ADJ NOUN NOUN PUNCT NOUN PUNCT X X
I 've entered for a chance to win a copy of @USER1136 on XB1 from @USER1071 thanks to @USER718 ! Enter HERE : URL1617	PRON AUX VERB ADP DET NOUN PART VERB DET NOUN ADP NOUN ADP NOUN ADP PROPN NOUN ADP NOUN PUNCT VERB ADV PUNCT X
Our military is doing everything it can to equip Iraq 's forces so our troop ... #MikeRogers #quotation URL1226	PRON NOUN AUX VERB PRON PRON AUX PART PROPN NOUN PART NOUN ADV PRON NOUN PUNCT X X X
join our book club and learn about a lot of great books URL1049	VERB PRON NOUN NOUN CCONJ VERB ADP DET NOUN ADP ADJ NOUN X
RT @USER2270 : Keep in mind that some things will never make sense , no matter how hard you try to figure it out . Let go , breathe deeply & l \u2026	X X PUNCT NOUN ADP NOUN PRON DET NOUN AUX ADV VERB NOUN PUNCT DET NOUN ADV ADJ PRON VERB PART VERB PRON ADV PUNCT VERB VERB PUNCT X X CCONJ X PUNCT
RT @USER487 : Where is AKMU Where is MADE full album Where is EXIT : X Where is YGGG Saddest ? Where is Minzy ?	X X PUNCT ADV AUX NOUN ADV AUX VERB ADJ NOUN ADV AUX NOUN PUNCT X ADV AUX NOUN NOUN PUNCT ADV AUX NOUN PUNCT
RT @USER2437 : If you have short memory let me inform you after signing COD Benazir made infamous NRO deal with Mushi . \u263a URL224 \u2026	X X PUNCT SCONJ PRON VERB ADJ NOUN VERB PRON VERB PRON ADP VERB NOUN NOUN VERB NOUN NOUN NOUN ADP NOUN PUNCT SYM X PUNCT
RT @USER1218 : @USER265 Blessed Sunday \ud83d\ude0a	X X PUNCT X X NOUN SYM
Just because a nigga f*cks you , Does Not mean he loves you !!	ADV SCONJ DET NOUN NOUN PRON PUNCT AUX PART VERB PRON VERB PRON PUNCT
Get Weather Updates from theweatherchannel 10:56:06	VERB NOUN NOUN ADP NOUN X
\ @USER1771 : Denial has become such a comfort for some that the truth has become an illusion . \	PUNCT NOUN PUNCT NOUN AUX VERB DET DET NOUN ADP DET DET DET NOUN AUX VERB DET NOUN PUNCT PUNCT
\ You should know , that if you come any closer .. I wo n't let you go . \	PUNCT PRON AUX VERB PUNCT PRON SCONJ PRON VERB DET NOUN PUNCT PRON AUX PART VERB PRON VERB PUNCT PUNCT
#NowPlaying Get Another Boyfriend of @USER1659	X VERB DET NOUN ADP NOUN
#baseball Bengie Molina considers retirement after World Series URL87	NOUN NOUN NOUN NOUN NOUN ADP PROPN PROPN NOUN
#championLife RT @USER2393 : Lakers game wo n't start until they get those rings right ? See you at 10:45	NOUN X X PUNCT PROPN NOUN AUX PART VERB SCONJ PRON VERB PRON NOUN ADV PUNCT VERB PRON ADP X
#howcome condoms smell so bad !!!!!!	PROPN NOUN VERB ADV ADJ PUNCT
#nothappy that Adelaide has lost the #rugbysevens	NOUN PRON NOUN AUX VERB DET NOUN
. @USER1012 & I are talking about optics entrepreneurship & \ the Actuality story \ tonight Media Lab E14 - 525 6 p - 8 p for URL51	PUNCT NOUN CCONJ PRON AUX VERB ADP NOUN NOUN CCONJ PUNCT DET NOUN NOUN PUNCT NOUN NOUN NOUN NOUN PUNCT NOUN NUM NOUN PUNCT NUM NOUN ADP NOUN
1 , 2 , 3 , 4 , 5 Teen Titans !	NUM PUNCT NUM PUNCT NUM PUNCT NUM PUNCT NUM NOUN NOUN PUNCT
; idk why ... but ifeel like talkin dirty O_o	PUNCT INTJ ADV PUNCT CCONJ NOUN ADP NOUN ADJ X
@ troy smith is about to finish the rest of the season for the 49ers ... he 's gon na get them a win this week	ADP PROPN PROPN AUX ADP PART VERB DET NOUN ADP DET NOUN ADP DET NOUN PUNCT PRON AUX VERB PART VERB PRON DET VERB DET NOUN
@USER90 NBC is going to have the NYC fireworks on . They are amazing - at least in person they were two years ago .	PROPN NOUN AUX VERB PART VERB DET NOUN NOUN ADP PUNCT PRON AUX ADJ PUNCT ADP ADV ADP NOUN PRON AUX NUM NOUN ADV PUNCT
@USER153 I 'm scoopin Jo right now	PROPN PRON AUX VERB PROPN ADV ADV
@USER272 I 'm from england . Where 's missiuri ?	PROPN PRON AUX ADP NOUN PUNCT ADV PART NOUN PUNCT
@USER288 i did tooo ! this is getting goood . lol	PROPN PRON AUX NOUN PUNCT PRON AUX VERB NOUN PUNCT INTJ
@USER312 well I 'm fuckn amazin .. lol ... tottaly awsome who 's bad now lol	PROPN CCONJ PRON AUX ADJ NOUN PUNCT INTJ PUNCT X X PRON AUX ADJ ADV INTJ
@USER349 I already have sis !!! Girl they hate me !	PROPN PRON ADV VERB NOUN PUNCT NOUN PRON VERB PRON PUNCT
@USER355 yea I was wondering if after they banned the indian we got a new one	PROPN INTJ PRON AUX VERB SCONJ SCONJ PRON VERB DET NOUN PRON VERB DET ADJ NUM
@USER357 :D	NOUN SYM
@USER367 lmbo	NOUN NOUN
@USER403 the one you said you was gon na make . the one i bought everything for and have been waiting for ?	VERB DET NOUN PRON VERB PRON AUX VERB PART VERB PUNCT DET NOUN PRON VERB PRON ADP CCONJ AUX AUX VERB ADP PUNCT
@USER446 how ??!	NOUN ADV NOUN
@USER447 miss yhuuuu !	NOUN VERB NOUN PUNCT
@USER547 that is the most stunning creature I have ever seen	VERB PRON AUX DET ADJ NOUN NOUN PRON VERB ADV VERB
@USER600 Yeah I m goodie just in the lab working ... Wow ! I need to be where you at ! lol let me visit	PROPN INTJ PRON AUX NOUN ADV ADP DET NOUN VERB PUNCT INTJ PUNCT PRON VERB PART AUX ADV PRON ADP PUNCT INTJ VERB PRON X
@USER678 that 's a tight score .	VERB PRON AUX DET NOUN NOUN PUNCT
@USER688 I hear enough talking , just turn round keep walking haha in that part	PROPN PRON VERB ADV VERB PUNCT ADV VERB NOUN VERB VERB INTJ ADP DET NOUN
@USER771 that 's ladybug	VERB PRON AUX NOUN
@USER842 hi , how are you good ? URL142	PROPN INTJ PUNCT ADV AUX PRON ADJ PUNCT X
@USER915 oh nasty perv lol	PROPN INTJ ADJ NOUN INTJ
@USER935 aight leaving my crib in 20 minutes	NOUN NOUN ADP PRON NOUN ADP NUM NOUN
@USER1007 has no sense !!! LOL	NOUN AUX DET NOUN PUNCT INTJ
@USER1022 I had potted shrimp last night . Except someone else ordered it & I could n't work out why we had creme brulee for a starter ...	PROPN PRON VERB NOUN NOUN ADJ NOUN PUNCT X PRON ADV VERB PRON CCONJ PRON AUX PART VERB ADV ADV PRON VERB NOUN NOUN ADP DET NOUN PUNCT
@USER1031 lol you 're lame ;)	PROPN INTJ PRON AUX ADJ SYM
@USER1039 benadryl is your friend lol	PROPN NOUN AUX PRON NOUN INTJ
@USER1074 @USER2632 @USER1318 @USER1108 can i have your email so i can invite you to a sample sale	PROPN PROPN PROPN NOUN AUX PRON VERB PRON NOUN ADV PRON AUX VERB PRON ADP DET NOUN NOUN
@USER1094 * jumps down walking over to you singing * Why do you do what you do to me ? Yea ! Why wo n't you answer me answer me ! Yea !	NOUN PUNCT NOUN ADV VERB ADV ADP PRON VERB PUNCT ADV VERB PRON VERB PRON PRON VERB ADP PRON PUNCT INTJ PUNCT ADV AUX PART PRON VERB PRON VERB PRON PUNCT INTJ PUNCT
@USER1144 right back atcha bro :)	PROPN ADV ADV NOUN NOUN SYM
@USER1163 haha u wish ! Just wait for me to fins a cool name tht has darren + loewe in it lol ( everything sounds bad :( )	PROPN INTJ PRON VERB PUNCT ADV VERB ADP PRON PART VERB DET ADJ NOUN PRON AUX NOUN SYM NOUN ADP PRON INTJ PUNCT PRON VERB ADJ NOUN PUNCT
@USER1255 Not as bent as my finger ! It looks freaky !	NOUN PART ADP NOUN ADP PRON NOUN PUNCT PRON VERB NOUN PUNCT
@USER1286 @USER2183 nigga u quit to	PROPN VERB NOUN PRON VERB ADP
@USER1290 give him my love !	NOUN VERB PRON PRON NOUN PUNCT
@USER1369 @USER2166 Woooooooow	NOUN NOUN X
@USER1381 of course she is lol	NOUN ADP ADV PRON AUX INTJ
@USER1435 ha ! I 'm gon na go with yes	PROPN INTJ PUNCT PRON AUX VERB PART VERB ADP INTJ
@USER1439 I 'M on east coast and their on . do n't know how that works live in CA. ? WITWIAL	PROPN PRON AUX ADP NOUN NOUN CCONJ PRON ADP PUNCT AUX PART VERB ADV PRON VERB VERB ADP NOUN PUNCT X
@USER1480 china	NOUN PROPN
@USER1485 .. hey no shine .. lol jk .. how been bro ?	NOUN PUNCT INTJ DET NOUN PUNCT INTJ INTJ PUNCT ADV AUX NOUN PUNCT
@USER1493 Key and Jjong are together . >.>	NOUN NOUN CCONJ NOUN AUX ADV PUNCT X
@USER1558 yea ik , just for me hahaa	PROPN INTJ NOUN PUNCT ADV ADP PRON NOUN
@USER1602 @USER1512 I uploaded / uploading remaining albums . Muackszx	PROPN VERB PRON VERB PUNCT NOUN ADJ NOUN PUNCT X
@USER1612 He better !! We buy his stuff ! haha	PROPN PRON ADV PUNCT PRON VERB PRON NOUN PUNCT INTJ
@USER1651 with there boycotts and the way they betrayed the country in ww1 they were right in there assessment	NOUN ADP PRON NOUN CCONJ DET NOUN PRON VERB DET NOUN ADP NOUN PRON AUX ADV ADP PRON NOUN
@USER1676 . Have u meet norway yet ?? Lol	NOUN PUNCT VERB PRON VERB NOUN ADV PUNCT INTJ
@USER1696 hey girl you awake ?????? And I did thanks !	PROPN INTJ NOUN PRON NOUN NOUN CCONJ PRON VERB NOUN PUNCT
@USER1733 Thanks for the #FF !	NOUN NOUN ADP DET NOUN PUNCT
@USER1756 nerp ! Wish I could	PROPN NOUN PUNCT VERB PRON AUX
@USER1763 thanks :3	NOUN NOUN X
@USER1773 come bring me lunch !	NOUN VERB VERB PRON NOUN PUNCT
@USER1774 >_> ok	NOUN NOUN INTJ
@USER1820 we got ta test guh ! My teacher said she gne strt takin off points if we late on test dayz ....	PROPN PRON VERB PART NOUN NOUN PUNCT PRON NOUN VERB PRON VERB VERB VERB ADP NOUN SCONJ PRON ADJ ADP NOUN NOUN PUNCT
@USER1969 Go to sleep . lol	NOUN VERB PART VERB PUNCT INTJ
@USER2055 perhaps	NOUN NOUN
@USER2082 I 'm a big fan of yours and admire your work , follow me ? [ /35	PROPN PRON AUX DET ADJ NOUN ADP PRON CCONJ VERB PRON NOUN PUNCT VERB PRON PUNCT PUNCT X
@USER2201 @USER944 they had their fun , we hd ours ! ;) lmaooo	PROPN NOUN PRON VERB PRON NOUN PUNCT PRON VERB NOUN PUNCT SYM INTJ
@USER2243 noo ... Sostar !!!!	NOUN NOUN PUNCT NOUN PUNCT
@USER2257 All my loving I will send to you \u2665	VERB DET PRON VERB PRON AUX VERB ADP PRON SYM
@USER2294 thanks .	PROPN NOUN PUNCT
@USER2337 Talking points ? #RobFord has a new idea to bring to City of Toronto politics : saving money instead of wasting it . #voteto	NOUN VERB NOUN PUNCT NOUN VERB DET ADJ NOUN PART VERB ADP NOUN ADP NOUN NOUN PUNCT VERB NOUN ADV ADP NOUN PRON PUNCT X
@USER2503 Reportedly Testing All - Dorito Taco Shell URL204	NOUN NOUN NOUN DET PUNCT X X X X
@USER2583 I think I thought a ticket the other day - PayPal says Yes , Eventbrite 's never heard of me . Can you confirm success / fail status ?	PROPN PRON VERB PRON VERB DET NOUN DET ADJ NOUN PUNCT X VERB INTJ PUNCT PROPN PART ADV VERB ADP PRON PUNCT AUX PRON VERB NOUN PUNCT NOUN NOUN PUNCT
@USER2589 where are you	NOUN ADV AUX PRON
@USER2626 swag	NOUN NOUN
A woman dat wants me fa me .... dat s all I ask for .	DET NOUN PRON VERB PRON VERB PRON PUNCT PRON AUX DET PRON VERB ADP PUNCT
Amateur Radio \u2013 Hurricane Katrina interview and audio | Survival Kits URL49	ADJ NOUN PUNCT NOUN NOUN NOUN CCONJ NOUN SYM X X X
Ambitious young Italians are quitting their country in droves , leaving power in the hands of an elderly elite . URL111 #tsunami	NOUN ADJ NOUN AUX VERB PRON NOUN ADP NOUN PUNCT VERB NOUN ADP DET NOUN ADP DET NOUN NOUN PUNCT X X
Be ready for anything because anything goes with me . Check out URL79 #match #sex #real	AUX ADJ ADP PRON SCONJ PRON VERB ADP PRON PUNCT VERB ADP NOUN X X X
Bob and Larry are my new best friends at work ! URL197	NOUN CCONJ PROPN AUX PRON ADJ ADJ NOUN ADP NOUN PUNCT X
Check out Cooking How - To : Homemade Frisco Melts on Tales of a midwestern Housewife ! URL15	VERB ADP NOUN ADV PUNCT ADP PUNCT NOUN X X ADP NOUN ADP DET NOUN NOUN PUNCT X
Cut it out joey ... * talkin to myself *	VERB PRON ADP NOUN PUNCT PUNCT NOUN ADP PRON PUNCT
Deputy pulls over FL man , naked teen in backseat ... URL201 #fl #florida #oops #dumb #sex #dui #traffic #news #police	NOUN VERB ADP NOUN NOUN PUNCT ADJ NOUN ADP NOUN PUNCT X X X X X X X X X X
Did I burn down the joint ? I DO N'T THINK SO . I was makin ornaments out of fish hooks .	AUX PRON VERB ADP DET NOUN PUNCT PRON AUX AUX VERB ADV PUNCT PRON AUX VERB NOUN ADP ADP NOUN NOUN PUNCT
Does it feel like Summer to you ? It does in Myrtle Beach , South Carolina it s 85 degrees	AUX PRON VERB ADP NOUN ADP PRON PUNCT PRON VERB ADP NOUN NOUN PUNCT PROPN PROPN PRON AUX NOUN X
Excellent article about Intelligent Management founder Lepore inspired by Jewish philosophy to find business solutions URL48	NOUN NOUN ADP NOUN NOUN PROPN NOUN VERB ADP NOUN NOUN PART VERB NOUN NOUN X
Excited for rough cut screening of @USER2147 tonight . Then season premier of Friday Night Lights at the Man-sion . Yessirr .	NOUN ADP ADJ VERB NOUN ADP NOUN NOUN PUNCT ADV NOUN NOUN ADP PROPN NOUN NOUN ADP DET NOUN PUNCT X PUNCT
Facing difficulties in serving elder family member get assistance from respite care service and live life peacefully . URL88	ADJ NOUN ADP NOUN NOUN NOUN NOUN VERB NOUN ADP NOUN NOUN NOUN CCONJ ADJ NOUN NOUN PUNCT X
Figurative speech #Englishmajors help me out : \ Twenty sails came into the harbor \ is an example of _____________ ? What figurative type ?	NOUN NOUN NOUN VERB PRON ADP PUNCT PUNCT NOUN NOUN VERB ADP DET NOUN PUNCT AUX DET NOUN ADP NOUN PUNCT PRON NOUN NOUN PUNCT
Forgiveness can not be given for those who choose to use Comic Sans in a business web application . #ui #fail	NOUN AUX PART AUX VERB ADP PRON PRON NOUN PART VERB NOUN NOUN ADP DET NOUN NOUN NOUN PUNCT X X
Good Morning	ADJ NOUN
Gothtober #BLANKtober	NOUN NOUN
Great Gizmos Indoor Garden Green Pots ( Green ) \u00a3 13.94 [ SAVE \u00a3 6.05 ] >> URL13 #bargains #deals 10.27.10	ADJ NOUN NOUN NOUN PROPN NOUN PUNCT PROPN PUNCT SYM NOUN PUNCT X SYM NOUN PUNCT PUNCT X X X X
Guess Who \ American Woman \	VERB PRON PUNCT ADJ NOUN PUNCT
Guhhh deeeh you !	PROPN VERB PRON PUNCT
HIGHHHHHH @USER1784 :)	NOUN NOUN SYM
Had Fun , Now I 'm Omw To My Gma House For Her Birthday	PRON NOUN PUNCT ADV PRON AUX VERB ADP PRON NOUN NOUN ADP PRON NOUN
Happy Guys Finish Last - EmpowHER.com URL156 v\u00eda @USER1854	ADJ NOUN NOUN NOUN PUNCT X X X X
Happy Main Event Day ! GL to all who are playing on Day 1A . Action begins at 3 ET .	ADJ NOUN NOUN NOUN PUNCT NOUN ADP DET PRON AUX VERB ADP NOUN NOUN PUNCT X NOUN ADP NUM PROPN PUNCT
Have #PR pros noticed this like #HR pros have ? RT @USER885 : Is HR morphing into PR ? Read and comment : URL39	AUX NOUN NOUN VERB PRON ADP NOUN NOUN VERB PUNCT X X PUNCT AUX NOUN NOUN ADP NOUN PUNCT VERB CCONJ NOUN PUNCT X
Having lunch at lp with 2 great & funny people @USER2359 && @USER2214	ADV NOUN ADP NOUN ADP NUM ADJ CCONJ ADJ NOUN X X X
How to Find And Cultivate Your Passion	ADV PART VERB CCONJ VERB PRON NOUN
I 'd like to take this over , , what I 'm tryin' to say is you should be mine ..	PRON AUX VERB PART VERB PRON ADV PUNCT PUNCT PRON PRON AUX VERB PART VERB AUX PRON AUX AUX PRON PUNCT
I 'm at Mr. Mikes . URL8	PRON AUX ADP NOUN NOUN PUNCT X
I 'm at Scopa ( 109A Plaza St. , Healdsburg Ave. , Healdsburg ) . URL5	PRON AUX ADP NOUN PUNCT NOUN X X PUNCT NOUN NOUN PUNCT NOUN PUNCT PUNCT X
I ai n't cheat I played the hand I dealt !	PRON AUX PART VERB PRON VERB DET NOUN PRON NOUN PUNCT
I am in concurrence ... Lol RT @USER2558 : @USER923 ex then lol	PRON AUX ADP NOUN PUNCT INTJ X X PUNCT X X ADV INTJ
I call my dad and this dude is blasting music . I ca nt understand him and he keeps saying \ what ? \ . Does n't that mean turn down the music ? =_=	PRON VERB PRON NOUN CCONJ DET NOUN AUX NOUN NOUN PUNCT PRON AUX PART VERB PRON CCONJ PRON VERB VERB PUNCT PRON PUNCT PUNCT PUNCT AUX PART PRON VERB VERB ADP DET NOUN PUNCT X
I do n't mean to stay awake at this hour . But that is what the poorest of all network would do you when you try to download !	PRON AUX PART VERB PART VERB NOUN ADP DET NOUN PUNCT CCONJ PRON AUX PRON DET NOUN ADP DET NOUN AUX VERB PRON ADV PRON VERB ADP NOUN PUNCT
I do n't see how a pumpkin patch can be more sincere than this one	PRON AUX PART VERB ADV DET NOUN NOUN AUX AUX ADJ NOUN ADP DET NUM
I do n't want any of these people in my house right now , do n't have anything to talk about , going to bed	PRON AUX PART VERB DET ADP DET NOUN ADP PRON NOUN ADV ADV PUNCT AUX PART VERB PRON PART VERB ADP PUNCT VERB ADP NOUN
I forgot just how good Molson Golden truly is ...... Thanks TIm O	PRON VERB ADV ADV ADJ NOUN NOUN ADV AUX ADJ NOUN X X
I hate how I am sometimes , it really sucks and I over think .	PRON VERB ADV PRON AUX ADV PUNCT PRON ADV NOUN CCONJ PRON ADV VERB PUNCT
I made $ 300 . That is on top of the $ 550 I 've made earlier on this trip . Not bad if I do say so myself .	PRON VERB SYM NUM PUNCT PRON AUX ADP NOUN ADP DET SYM NOUN PRON AUX VERB VERB ADP DET NOUN PUNCT ADV ADJ SCONJ PRON AUX VERB ADV PRON PUNCT
I posted 11 photos on Facebook in the album \ October 26 , 2010 \ URL67	PRON VERB NUM NOUN ADP PROPN ADP DET NOUN PUNCT PROPN NUM PUNCT NUM PUNCT X
I think I do +_O \ you 're sick \ RT @USER878 : Lmao u do n even know what that means RT @USER862 : Lol nawe lol RT	PRON VERB PRON AUX NOUN PUNCT PRON AUX ADJ PUNCT X X PUNCT INTJ PRON VERB CCONJ ADV VERB PRON PRON VERB X X PUNCT INTJ X INTJ X
I think jawn was tryna be smart talk'n bout da baul little do she know I d nt give two shits about none of these Cheyney boy 's .	PRON VERB NOUN AUX VERB AUX ADJ NOUN ADP DET NOUN ADJ AUX PRON VERB PRON VERB PART VERB NUM NOUN ADP NOUN ADP DET NOUN NOUN PART PUNCT
I wan na do something tonight .	PRON VERB PART VERB PRON NOUN PUNCT
I want Brazilian food	PRON VERB VERB NOUN
If you can see only one Darfur documentary this year , I recommend The Devil Came on Horseback . URL2	SCONJ PRON AUX VERB ADV NUM NOUN NOUN DET NOUN PUNCT PRON VERB DET NOUN VERB ADP NOUN PUNCT X
It 's raining !! \ue330\ue04b	PRON AUX VERB PUNCT X
It s the little things that strengthen my tiny wings .	PRON AUX DET ADJ NOUN PRON VERB PRON ADJ NOUN PUNCT
Know the Professionals , Information and facts on Cosmetic Dentist Procedures and Treatments : Anybody unfamiliar ... URL50	VERB DET NOUN PUNCT NOUN CCONJ NOUN ADP NOUN X X CCONJ NOUN PUNCT PRON NOUN PUNCT X
Lol welcome to Twitter @USER2290	INTJ NOUN ADP PROPN X
Lorex LW2003 LIVE snap Video Baby Monitor ( White ) : Get The Lowest Prices On NEW Lorex LW2003 LIVE snap Video Bab ... URL41	ADJ NOUN PROPN NOUN NOUN NOUN NOUN PUNCT ADJ PUNCT PUNCT VERB DET NOUN NOUN ADP ADJ NOUN X PROPN NOUN NOUN NOUN PUNCT X
MATCHES YA FACE SO YOU COOL . RT @USER1964 : @USER127 it s growing but it s at this ugly stage :(	PROPN NOUN NOUN ADV PRON ADJ PUNCT X X PUNCT VERB PRON AUX VERB CCONJ PRON AUX ADP DET ADJ NOUN SYM
Me too , me too , me too RT @USER1524 @USER2374 i hope u come i hope u come i hope u come	PRON ADV PUNCT PRON ADV PUNCT PRON ADV X X X PRON VERB PRON VERB PRON VERB PRON VERB PRON VERB PRON VERB
My book trailer - WORST SINGING EVER ! YAY ! : URL147	PRON NOUN NOUN PUNCT ADJ NOUN NOUN PUNCT X PUNCT PUNCT X
My friends category is odd again -.-	PRON NOUN NOUN AUX ADJ ADV NOUN
New FC Menu Utility 2.0 #apple URL138	ADJ NOUN NOUN X NUM X X
New NC Highway Signs Welcome Motorists To \ Most Military Friendly State \ : New signs going up on the major highways ... URL37	ADJ PROPN NOUN NOUN NOUN NOUN PART PUNCT ADJ NOUN ADJ NOUN PUNCT PUNCT ADJ NOUN VERB ADP ADP DET ADJ NOUN PUNCT X
Noo it s not cuss you have swag andd you wo nt look dumb ! @USER2646 !!	VERB PRON AUX PART VERB PRON AUX NOUN NOUN PRON AUX PART VERB ADJ PUNCT NOUN PUNCT
Northrop Grumman 3Q profit rises , boosts forecast ( AP ) : AP - Defense contractor Northrop Grumman Corp. say ... URL24	PROPN NOUN NOUN NOUN NOUN PUNCT NOUN NOUN PUNCT PROPN PUNCT PUNCT PROPN PUNCT NOUN X X X X VERB PUNCT X
Not too bad for missing two labs before that !	ADV ADV ADJ ADP NOUN NUM NOUN ADP PRON PUNCT
On eve of UFC debut , James Toney learned of IRS lien , fight purse withheld URL177	ADP NOUN ADP NOUN NOUN PUNCT PROPN PROPN VERB ADP PROPN NOUN PUNCT VERB X X X
Oo yeaa ii hear thunda ! Rainnn kum onnnnnn	PROPN NOUN AUX VERB NOUN PUNCT X X X
Pain is pleasure	NOUN AUX NOUN
People in school thought my shoes were so sick today . alala . Robert wanted to take them :)) and Jack and Craig tried to wear it . fun day .	NOUN ADP NOUN VERB PRON NOUN AUX ADV ADJ NOUN PUNCT X PUNCT X VERB PART VERB PRON NOUN CCONJ PROPN CCONJ PROPN VERB PART VERB PRON PUNCT NOUN NOUN PUNCT
Phoooonneeeeeeeeee with my wife !	VERB ADP PRON NOUN PUNCT
Pretty simple actually . - The DataContext will tunnel down to controls below it in the tree . - The ListBox ... URL31 #WPF #2010	ADV ADJ ADV PUNCT PUNCT DET NOUN AUX VERB ADV PART NOUN ADP PRON ADP DET NOUN PUNCT PUNCT DET NOUN PUNCT X X X
Public and private jobs | Angry Bear : The wife and I used to work retail for the California State Parks . If our pa ... URL18	NOUN CCONJ ADJ NOUN SYM X X PUNCT DET NOUN CCONJ PRON VERB PART VERB ADJ ADP DET PROPN PROPN PROPN PUNCT SCONJ PRON NOUN PUNCT X
Q : So , if I may ask , how would we \ meet u ... A : Lol . I have no clue and yes I would , i ... : URL210	NOUN PUNCT ADV PUNCT SCONJ PRON AUX VERB PUNCT ADV AUX PRON PUNCT VERB PRON PUNCT DET PUNCT INTJ PUNCT PRON VERB DET NOUN CCONJ INTJ PRON AUX PUNCT PRON PUNCT PUNCT X
RT @USER93 : @USER1691 @USER1809 @USER2600 @USER2628 Chck out I CAN RAP ! URL216 & the TAKEOVER ! URL214 ...	X X PUNCT X X X X X ADP PRON AUX NOUN PUNCT NOUN CCONJ DET NOUN PUNCT X PUNCT
RT @USER237 : d-town !	X X PUNCT NOUN PUNCT
RT @USER243 : Bruno Mars hates it when cameramen zoom in too close . #CelebsFacts	X X PUNCT PROPN PROPN VERB PRON ADV NOUN NOUN ADP ADV ADJ PUNCT X
RT @USER337 : I just missed the best twitpic opportunity smh .. This nigga was bald all over but had a pony tail of dreads lol <- \ue40b\ue107\ue107\ue107	X X PUNCT PRON ADV VERB DET ADJ NOUN NOUN INTJ PUNCT DET NOUN AUX VERB DET ADV CCONJ VERB DET NOUN NOUN ADP NOUN INTJ X X
RT @USER410 : Staring at a hot guy and thinking ... We are going to make beautiful babies .	X X PUNCT NOUN ADP DET ADJ NOUN CCONJ VERB PUNCT PRON AUX VERB PART VERB ADJ NOUN PUNCT
RT @USER465 : Damn , when u hit your toe on the door you wan na say every cuss word you know	X X PUNCT INTJ PUNCT ADV PRON VERB PRON NOUN ADP DET NOUN PRON VERB PART VERB DET NOUN NOUN PRON VERB
RT @USER521 : \ Do what you can , with what you have , where you are . \ - Theodore Roosevelt	X X PUNCT PUNCT AUX PRON PRON AUX PUNCT ADP PRON PRON VERB PUNCT ADV PRON VERB PUNCT PUNCT PUNCT X X
RT @USER887 : when in a relationship You need to understand the other person feelings besides yours .	X X PUNCT ADV ADP DET NOUN PRON VERB PART VERB DET ADJ NOUN NOUN NOUN PRON PUNCT
RT @USER951 : Just seen one of my favorite people @USER1297 ... I love her I swear . Muah ! ** awwyyy ! Me heart yu 4x more loveeee !	X X PUNCT ADV VERB NUM ADP PRON NOUN NOUN NOUN PUNCT PRON VERB PRON PRON VERB PUNCT NOUN PUNCT PUNCT NOUN PUNCT PRON NOUN PRON VERB ADV NOUN PUNCT
RT @USER1119 : I wish someone would have told me that it 's okay to cry over nothing and everything for a little while . #HuggiesMom	X X PUNCT PRON VERB PRON AUX VERB VERB PRON SCONJ PRON AUX ADJ PART VERB ADP PRON CCONJ PRON ADP DET ADJ NOUN PUNCT X
RT @USER1135 : Billionaires / CEOs throwing massive $$$ into front Orgs since Citizens United . They plan to BUY America Gov't in 201 ...	X X PUNCT NOUN PUNCT VERB VERB ADJ NOUN ADP NOUN NOUN ADP PROPN PROPN PUNCT PRON VERB ADP VERB PROPN NOUN ADP NOUN PUNCT
RT @USER1191 : I never bought candy bars from those kids on my doorstep so I guess they \u2019re all in gangs now .	X X PUNCT PRON ADV PRON NOUN NOUN ADP PRON NOUN ADP PRON NOUN ADV PRON VERB PRON VERB DET ADP NOUN ADV PUNCT
RT @USER1226 : @USER1642 lol you know i m down like 4 flats on a cadillac ... lol wut it do ?? || Haha ! love it	X X PUNCT PROPN INTJ PRON VERB PRON AUX ADV ADP NUM NOUN ADP DET NOUN PUNCT INTJ X PRON VERB PUNCT PROPN INTJ PUNCT VERB PRON
RT @USER1233 : Eat that pussc like cold pizza lol	X X PUNCT VERB PRON NOUN ADP ADJ NOUN INTJ
RT @USER1388 : I rather watch water boil ......	X X PUNCT PRON VERB VERB NOUN NOUN X
RT @USER1438 : #Quote of the day : \ Fear is just as contagious as courage . Your choice . \	X X PUNCT NOUN ADP DET NOUN PUNCT PUNCT NOUN AUX ADV ADP NOUN ADP NOUN PUNCT PRON NOUN PUNCT PUNCT
RT @USER1497 : You aint sh*t .	X X PUNCT PRON AUX NOUN PUNCT
RT @USER1583 : you do nt know shit , about shit	X X PUNCT PRON AUX PART VERB NOUN PUNCT ADP NOUN
RT @USER1594 : #nsnweekend how can people choose there favourite performance , the whole thing was perfect !	X X PUNCT NOUN ADV AUX NOUN NOUN PRON ADJ NOUN PUNCT DET ADJ NOUN AUX ADJ PUNCT
RT @USER1818 : Home Opener is 2 days away . Need a costume ? 1st 5000 fans get a Halloween black & orange @USER146 yth jersey URL0 ...	X X PUNCT NOUN NOUN AUX NUM NOUN ADV PUNCT VERB DET NOUN PUNCT ADJ NOUN NOUN VERB DET NOUN ADJ CCONJ NOUN X X X X PUNCT
RT @USER1826 : Tonight I 'm at Club West in San Antonio ... This is what it was like the last time I was there . ( cont ) URL182	X X PUNCT X PRON AUX ADP NOUN NOUN ADP PROPN NOUN PUNCT PRON AUX PRON PRON AUX ADP DET ADJ NOUN PRON AUX ADV PUNCT PUNCT NOUN PUNCT X
RT @USER1992 : When life gives you a hundred reasons to cry , stay strong ! Show life that you have a thousand reasons to smile . - Unknown	X X PUNCT ADV NOUN VERB PRON DET NOUN NOUN PART VERB PUNCT VERB ADJ PUNCT NOUN NOUN SCONJ PRON VERB DET NOUN NOUN ADP VERB PUNCT PUNCT X
RT @USER2314 : Seeing warped tour ads everywhere makes me want to cry . My favorite bands are having signings and it s killing me alfhak	X X PUNCT X X NOUN NOUN ADV VERB PRON VERB PART VERB PUNCT PRON NOUN NOUN AUX VERB NOUN CCONJ PRON AUX VERB PRON X
RT @USER2484 : \ Daddy , what are THESE ? Can I have one ? These . Are . AWESOME !! \ Louis , 9 , finding a VHS .	X X PUNCT PUNCT NOUN PUNCT PRON AUX PRON PUNCT AUX PRON VERB NUM PUNCT DET PUNCT VERB PUNCT NOUN PUNCT PUNCT PROPN PUNCT NUM PUNCT VERB DET NOUN PUNCT
Say Anything with boyfriend . :))	VERB NOUN ADP NOUN PUNCT X
Security Clearance | Systems Admin - Integrated Exploitation Capability ( IEC ) - Lentech , Inc. - St .... URL25 #missouri #jobs	NOUN NOUN SYM NOUN NOUN PUNCT NOUN X NOUN PUNCT NOUN PUNCT PUNCT NOUN PUNCT NOUN PUNCT PROPN PUNCT X X X
Self control app again . Geniusness .	NOUN NOUN NOUN ADV PUNCT X PUNCT
So I told @USER1847 I was gon na tweet from my gate , this is my tweet , there 's some cute guys in hereee . Hollaaaaa	ADV PRON VERB VERB PRON AUX VERB PART VERB ADP PRON NOUN PUNCT PRON AUX PRON NOUN PUNCT PRON AUX DET ADJ NOUN ADP NOUN PUNCT X
So supernatural . Actual and factual . Unstoppable , I 'm possibly the illest possibility .	ADV NOUN PUNCT NOUN CCONJ NOUN PUNCT X PUNCT PRON AUX VERB DET NOUN NOUN PUNCT
TCA to play for Colorado 3A women 's soccer championship . #charterschool #tca #soccer	NOUN PART VERB ADP PROPN NOUN NOUN PART NOUN NOUN PUNCT X X X
THE HEAT WO N'T BE READY ITIL JANUARY BUT WE WILL	DET NOUN AUX AUX AUX ADJ NOUN NOUN CCONJ PRON AUX
TRUE BLOOD tonight ... still not sure I am gon na like the new XANADU style storyline they are getting into ... URL47	ADJ NOUN NOUN PUNCT ADV PART ADJ PRON AUX VERB PART ADP DET ADJ NOUN NOUN NOUN PRON AUX VERB ADP PUNCT X
The 50 % Return Method Billionaire Investor Warren Buffet Wishes He Could Use , You Can Use ! URL159	DET NUM SYM NOUN NOUN PROPN NOUN PROPN X X PRON AUX VERB PUNCT PRON AUX VERB PUNCT X
Traffic Generation Strategy : How to Make Any Contest a Slam - Dunk : URL10	NOUN ADJ NOUN PUNCT ADV PART VERB DET NOUN DET NOUN PUNCT X PUNCT X
Twitter off#	PROPN X
Ugh i need a new phone >:I ay !	PROPN PRON VERB DET ADJ NOUN NOUN NOUN PUNCT
Umm @USER1404 took away my favorites and my Dm 's from Aaron ! Lol Naw this is serious ! and slackness .	PROPN NOUN VERB ADV PRON NOUN CCONJ PRON NOUN PART ADP NOUN PUNCT INTJ X PRON AUX ADJ PUNCT CCONJ NOUN PUNCT
Upcoming rap artist ? OMFG !! I do n't think so URL9 ! Chuck Norris Starbucks iPod	PROPN PROPN NOUN PUNCT NOUN PUNCT PRON AUX PART VERB ADV NOUN PUNCT X X X X
Washing my motorcycle	VERB PRON NOUN
Welcome to our twitter page ! Here we will update you with our weekly specials and monthly giveaways !	NOUN ADP PRON PROPN NOUN PUNCT ADV PRON AUX VERB PRON ADP PRON NOUN NOUN CCONJ NOUN NOUN PUNCT
What should be the length of your #maternity #wear ? -part I URL52	PRON AUX AUX DET NOUN ADP PRON NOUN NOUN PUNCT X PRON X
Whooaaaa bro these CELTICS are god dammmm babies !!! MAN UP	PROPN NOUN DET PROPN AUX NOUN NOUN NOUN PUNCT NOUN ADP
Wo nt let that ruin my night tho ... i m not #goingtobedangry	NOUN PART VERB PRON VERB PRON NOUN ADV PUNCT PRON AUX PART ADJ
Word I 'm bout to holla at her via twitter RT @USER1971 : #trushit - i m tryna fucc nicki minaj lol	PROPN PRON AUX VERB ADP VERB ADP PRON ADP PROPN X X PUNCT X PUNCT PRON AUX VERB NOUN X X INTJ
Wow deep lyrics \ when you smile I smile \	INTJ ADJ NOUN PUNCT ADV PRON VERB PRON VERB PUNCT
Wow stuck my hand in his cage and he ran and hid in his tubes /:	INTJ VERB PRON NOUN ADP PRON NOUN CCONJ PRON VERB CCONJ NOUN ADP PRON NOUN X
answer : spouting , @USER2570 8/388 points , meaning : URL71	NOUN PUNCT NOUN PUNCT NOUN X NOUN PUNCT X PUNCT X
enjoys a good Snog at lunchtime .	VERB DET ADJ NOUN ADP NOUN PUNCT
going through my flickr .. just thought i d re-share my fave pic of @USER2542 from toronto warped . URL68 <3	VERB ADP PRON NOUN PUNCT ADV VERB PRON VERB VERB PRON ADJ NOUN ADP NOUN ADP PROPN NOUN PUNCT X SYM
it s sad that i m just now watching the Britney #Glee episode , smh	PRON AUX ADJ SCONJ PRON AUX ADV ADV VERB DET PROPN NOUN NOUN PUNCT INTJ
jk one more . URL199	INTJ NUM ADV PUNCT X
just did some unfollows .. I hate havin #deadweight on my TL	ADV VERB DET NOUN PUNCT PRON VERB NOUN NOUN ADP PRON X
kid cudi is a faggot , that is all	NOUN NOUN AUX DET NOUN PUNCT PRON AUX DET
kinda like that . making a diff in someone s life .	ADV ADP PRON PUNCT VERB DET NOUN ADP PRON AUX NOUN PUNCT
o_o lol RT @USER609 I Herd You Was Good With Themm Softt Lips	PROPN INTJ X X PRON VERB PRON AUX ADJ ADP NOUN X X
rape - the unlawful compelling of a woman through physical force or duress to have sexual intercourse .	NOUN PUNCT DET NOUN NOUN ADP DET NOUN ADP ADJ NOUN CCONJ NOUN PART VERB ADJ NOUN PUNCT
reading harry potter in bed ! waiting for the new south park to come on	VERB NOUN NOUN ADP NOUN PUNCT VERB ADP DET ADJ NOUN NOUN PART VERB ADP
wearing my high school track hoodie ... #memories	VERB PRON ADJ NOUN NOUN NOUN PUNCT X
when is butt pride ? cause i got a big ol trunk wit junk it it	ADV AUX NOUN NOUN PUNCT SCONJ PRON VERB DET ADJ NOUN NOUN ADP NOUN PRON PRON
women music and pineapple @USER738 What are three things you guys just ca nt live without ? #tellme	NOUN NOUN CCONJ NOUN NOUN PRON AUX NUM NOUN PRON NOUN ADV AUX PART VERB ADP PUNCT X
would n't that be fucked up if they added a year to Lil Wayne 's jail sentence ? lol	AUX PART PRON AUX VERB ADP SCONJ PRON VERB DET NOUN ADP PROPN PROPN PART NOUN NOUN PUNCT INTJ
@USER1145 Awwww kitty loves you <3	PROPN NOUN NOUN VERB PRON SYM
RT @USER1959 : This face will be all over your computer screen tomorrow night at 8 PM ET ! \ud83d\ude0d URL933 #iHeartZayn URL218 \u2026	X X PUNCT DET NOUN AUX AUX DET ADP PRON NOUN NOUN NOUN NOUN ADP NUM NOUN PROPN PUNCT SYM X X X PUNCT
This being human is a guest house . Every morning a new arrival .	PRON AUX NOUN AUX DET NOUN NOUN PUNCT DET NOUN DET ADJ NOUN PUNCT
RT @USER186 : Gavin McInnes \u2013- Tattoo Advice from a Comedian URL787 URL1464	X X PUNCT X X X NOUN NOUN ADP DET NOUN X X
Kiss Daniel \u2013 New Era ( Album Tracklist ) : The highly anticipated Kiss Daniel debut album , NEW ERA ... URL955 #Letsdanzit	NOUN PROPN PUNCT ADJ NOUN PUNCT NOUN NOUN PUNCT PUNCT DET ADJ NOUN NOUN PROPN ADJ NOUN PUNCT ADJ NOUN PUNCT X X
Hi Kerry , please register at URL833 if you would like our support . URL591	INTJ NOUN PUNCT INTJ NOUN ADP NOUN SCONJ PRON AUX VERB PRON NOUN PUNCT X
Wednesday Special : Roast Beef with Mash Potatoes and vegetables ....... \u20ac 9.95 .	PROPN NOUN PUNCT NOUN NOUN ADP NOUN NOUN CCONJ NOUN SYM X X PUNCT
When your conductor accidentally throws his baton in the middle of rehearsal \ud83d\ude33\ud83d\ude05	ADV PRON NOUN ADV VERB PRON NOUN ADP DET NOUN ADP NOUN X
@USER2487 if I join silver , this will match my name	NOUN SCONJ PRON VERB NOUN PUNCT PRON AUX VERB PRON NOUN
RT @USER1296 : #Hope Is Necessary When Living with #Migraine \u2013 A Video URL385 @USER239 URL1335	X X PUNCT NOUN AUX NOUN ADV NOUN ADP NOUN PUNCT DET NOUN X X X
@USER1488 How can my parcel go missing at your depot ? Had to fork out for another replacement #unimpressed	NOUN ADV AUX PRON NOUN VERB NOUN ADP PRON NOUN PUNCT VERB PART VERB ADP ADP DET NOUN X
RT @USER226 : . @USER798 and her grave can be visited at St Peter 's Church in Bournemouth #MaryShelley URL1008	X X PUNCT PUNCT NOUN CCONJ PRON NOUN AUX AUX NOUN ADP PROPN NOUN PART NOUN ADP NOUN X X
RT @USER475 : A day without laughter is a day wasted .	X X PUNCT DET NOUN ADP NOUN AUX DET NOUN NOUN PUNCT
#Deals #7994 3pcs 7.4 V 2000 mAh Battery + Charger For Syma X8W X8C X8G RC Quadcopter Banana P \u2026 URL248 URL658	NOUN NOUN NOUN X X NOUN NOUN NOUN SYM NOUN ADP NOUN X X X X X X X PUNCT X X
Killer #eCommerce Starts With Your #CRM URL462 URL977	NOUN NOUN NOUN ADP PRON NOUN X X
@USER872 like afternoon or early mornin ?	NOUN ADP NOUN CCONJ ADJ NOUN PUNCT
RT @USER2611 : #booktrailer , #paranormal , #fantasy URL128 Buy link : URL114 URL171	X X PUNCT NOUN PUNCT NOUN PUNCT X X VERB NOUN PUNCT X X
RT @USER1345 : When the BBoyz bust out ampme at the school cafe \ud83d\ude02 URL1034	X X PUNCT ADV DET NOUN NOUN ADP NOUN ADP DET NOUN NOUN SYM X
RT @USER2090 : This is Scalia speaking at a commencement in 2010 ... URL768	X X PUNCT PRON AUX NOUN VERB ADP DET NOUN ADP NUM PUNCT X
RT @USER827 : 10 Internet Jokes that Resulted in Jail URL874 \u2026 > URL1333	X X PUNCT NUM NOUN NOUN PRON NOUN ADP NOUN NOUN PUNCT PUNCT X
I am truly blessed . \ud83d\ude07 URL1253	PRON AUX ADV ADJ PUNCT X X
RT @USER120 : Are you ready for an adventure ? URL1026	X X PUNCT AUX PRON ADJ ADP DET NOUN PUNCT X
@USER141 My favourite phrase for them .	VERB PRON ADJ NOUN ADP PRON PUNCT
14221 started on 08/05/2016 Reached its destination CPA and was 10 Mins Before URL945	NOUN VERB ADP NOUN NOUN PRON NOUN NOUN CCONJ AUX NUM NOUN ADP NOUN
visited Ky \u2764\ufe0f they added so many babies it s cray	PROPN NOUN SYM PRON VERB ADV ADJ NOUN PRON AUX NOUN
Those couples and girls are online now . Visit them now : URL1342 #cam #ebony #webcam #webcammodel URL507	NOUN NOUN CCONJ NOUN AUX ADJ ADV PUNCT VERB PRON ADV PUNCT X X X X X X
RT @USER281 : Discover Various Facts about Reptiles From KidRhymes - URL535	X X PUNCT X ADJ NOUN ADP NOUN ADP NOUN PUNCT X
An invigorating flourish of creativity originates from the rec ... More for Pisces URL244	DET NOUN NOUN ADP NOUN NOUN ADP DET NOUN PUNCT ADJ ADP NOUN X
RT @USER234 : Fancy a Trip Around Taylor Swift 's House ? URL1081 URL311	X X PUNCT VERB DET NOUN ADP PROPN PROPN PART PROPN PUNCT X X
RT @USER1576 : I miss having someone 's company	X X PUNCT PRON VERB VERB PRON AUX NOUN
RT @USER151 : Mean Girls URL582	X X PUNCT X NOUN X
I 'm honestly too sad to sleep now	PRON AUX ADV ADV ADJ PART VERB ADV
RT @USER1257 : Parents be like : you got mail URL463	X X PUNCT NOUN AUX VERB PUNCT PRON VERB NOUN X
RT @USER1266 : #BOHO JEWELRY #Bohemian #Jewelry Stretch #Bracelet #etsy #handmade by JabberDuck URL770 URL225 \u2026	X X PUNCT X X X X X X X X ADP NOUN X X PUNCT
RT @USER1499 : \ud83d\ude0d\ud83d\ude0d \ Two piece double lined bikini \ Use Discount Code \ YUNG \ For 15 % OFF \u203c\ufe0f on SALE now at URL964 URL219 \u2026	X X PUNCT NOUN PUNCT NUM NOUN NOUN NOUN NOUN PUNCT VERB NOUN NOUN PUNCT NOUN PUNCT ADP NUM SYM ADV NOUN ADP NOUN ADV ADP PROPN X PUNCT
RT @USER408 : Scientist : we 've finally taught a dog Morse Code Dog : [ taps paw ] Me : what did it say ? Scientist : \ woof \	X X PUNCT X PUNCT PRON AUX ADV VERB DET NOUN NOUN X X PUNCT PUNCT X X PUNCT PRON PUNCT PRON VERB PRON VERB PUNCT X PUNCT PUNCT X PUNCT
RT @USER643 : Nadine and Kyla !!! \ud83d\ude0d \u00a9 #JaDineInLoveSingapore URL795	X X PUNCT NOUN CCONJ NOUN PUNCT SYM X X X
@USER1156 Stunningly Beautiful as Always	NOUN NOUN ADJ SCONJ ADV
it 's game day ... go stangs !	PRON AUX NOUN NOUN PUNCT VERB NOUN PUNCT
RT @USER1926 : Who was removed aftr #GHQ . #MehranBase , #KamraBae , #ParadeLane attacks ? Y #BKU vice - chancellor ? #Marwat Saeb is a prof nt Ge \u2026	X X PUNCT PRON AUX ADJ NOUN NOUN PUNCT NOUN PUNCT NOUN PUNCT NOUN NOUN PUNCT PRON NOUN NOUN PUNCT NOUN PUNCT X NOUN AUX DET NOUN PART NOUN PUNCT
\u266c Mass Effect ( Original Mix ) - Audiocells	NOUN NOUN NOUN PUNCT NOUN NOUN PUNCT PUNCT X
\ I pay you back in car rides and shit \ bitch I have my own car .	PUNCT PRON VERB PRON ADV ADP NOUN NOUN CCONJ NOUN PUNCT NOUN PRON VERB PRON ADJ NOUN PUNCT
I posted a new photo to Facebook URL266	PRON VERB DET ADJ NOUN ADP PROPN X
{ GHYR rewind } New Release Round - Up February 29th - March 6th Hey Girl ! Check out these new re URL1005 #BlackAuthors #BlackLit	ADJ NOUN NOUN NOUN ADJ NOUN VERB PUNCT ADP NOUN NOUN PUNCT PROPN PROPN INTJ NOUN PUNCT VERB ADP DET ADJ AUX X X X
\u273f I voted for @USER2116 #NNGlamourGuruKaycee in #Blogopolis4D for best #BeautyBlog ! URL1094	PROPN PRON VERB ADP NOUN NOUN ADP NOUN ADP ADJ NOUN PUNCT X
#PrayForHayes @USER972 Everything will be okay , i 'm sure \ud83d\udc95	PROPN PROPN PRON AUX AUX ADJ PUNCT PRON AUX ADJ SYM
@USER1935 as a Muslim do you also support pedophillia and violent extremism ? Scrolled thru ur tweets , did n't see you speak against that	NOUN ADP DET NOUN AUX PRON ADV VERB NOUN CCONJ NOUN NOUN PUNCT X X PRON NOUN PUNCT AUX PART VERB PRON VERB ADP PRON
7 PM EST / 1 AM CEST - #GLITCH Label takeover - #hackplaybx #beatmeetandgreet #AndrewFreedmanHome - TONIGHT - URL356	NUM NOUN NOUN PUNCT NUM NOUN NOUN PUNCT X X X PUNCT X X X PUNCT NOUN PUNCT X
I just want a woman who different from women in this generation ...	PRON ADV VERB DET NOUN PRON ADJ ADP NOUN ADP DET NOUN PUNCT
Article spinner software is the best fit with SEO ! URL475	PROPN NOUN NOUN AUX DET ADJ NOUN ADP NOUN PUNCT X
RT @USER2568 : the red stan . constantly talks about the album and her long straight hair . bitter red did n't win a grammy . probably has a nic \u2026	X X PUNCT DET ADJ NOUN PUNCT ADV VERB ADP DET NOUN CCONJ PRON ADJ ADV NOUN PUNCT X X AUX PART VERB DET NOUN PUNCT ADV VERB DET NOUN PUNCT
RT @USER1814 : Discover how scrubbing dots make the difference w/ the Scrubbing Dish Cloth ! #ScrubCloth #sweepstakes URL961 \u2026	X X PUNCT VERB ADV NOUN NOUN VERB DET NOUN NOUN DET NOUN NOUN NOUN PUNCT X X X PUNCT
RT @USER1272 : A lot of R3 orphans and widows are afflicted by Stockholm Syndrome and are craving for attention of PTs in Twitter	X X PUNCT DET NOUN ADP NOUN NOUN CCONJ NOUN AUX NOUN ADP NOUN NOUN CCONJ AUX NOUN ADP NOUN ADP NOUN ADP PROPN
@USER89 @USER974 @USER2387 @USER412 @USER2445 haha she s #bd fan not asmii hater nd hibha lover \ud83d\ude02	PROPN PROPN PROPN PROPN PROPN INTJ PRON AUX ADJ NOUN PART ADJ NOUN NOUN X NOUN SYM
RT @USER1354 : If keyboards came with braille on them , we all could have subconsciously learned braille by now .	X X PUNCT SCONJ NOUN VERB ADP NOUN ADP PRON PUNCT PRON DET AUX VERB NOUN VERB NOUN ADP ADV PUNCT
RT @USER1893 : Born under a bad sign , you saved my life That night on the roof of your hotel	X X PUNCT NOUN VERB DET ADJ NOUN PUNCT PRON VERB PRON NOUN DET NOUN ADP DET NOUN ADP PRON NOUN
RT @USER1247 : T 2315 - Amazing moment : Raj Kapoor , Shammi Kapoor , Shashi Kapoor with their Mother .. URL755	X X PUNCT X NOUN PUNCT X NOUN PUNCT X X PUNCT X NOUN PUNCT NOUN NOUN ADP PRON NOUN PUNCT X
RT @USER1053 : A fantastical mix of mythology and derring - do : URL894 available now on all good #ebook formats . #asmsg \u2026	X X PUNCT DET NOUN NOUN ADP NOUN CCONJ NOUN PUNCT VERB PUNCT NOUN ADV ADV ADP DET ADJ NOUN NOUN PUNCT X PUNCT
RT @USER2048 : I 'm pretty sure he 'll do a follow spree today . #mondaymotivation	X X PUNCT PRON AUX ADV ADJ PRON AUX VERB DET NOUN NOUN NOUN PUNCT X
Where has my social media presence gone ? Why are n't you all liking my stuff ?	ADV VERB PRON ADJ NOUN NOUN VERB PUNCT ADV AUX PART PRON DET VERB PRON NOUN PUNCT
Want to stay current on an event or trend ? Let @USER1141 discover and share the content for you . URL1625	VERB PART VERB ADJ ADP DET NOUN CCONJ VERB PUNCT VERB NOUN NOUN CCONJ VERB DET NOUN ADP PRON PUNCT X
Nine killed , eight missing in landslide in Arunachal Pradesh URL926 #TopNews #India	NOUN VERB PUNCT NUM NOUN ADP NOUN ADP NOUN X X X X
RT @USER580 : me on my first date URL1032	X X PUNCT PRON ADP PRON ADJ NOUN X
RT @USER2289 : * retweets * * un-retweets * * quotes and says LMAOOOOOOO * * retweets *	X X PUNCT PUNCT NOUN PUNCT PUNCT NOUN PUNCT PUNCT NOUN CCONJ VERB NOUN PUNCT PUNCT NOUN PUNCT
RT @USER1760 : You only need two close friends in which you can trust and dedicate yourself to . Having too many friends can lead to de \u2026	X X PUNCT PRON ADV VERB NUM ADJ NOUN ADP SCONJ PRON AUX VERB CCONJ VERB PRON ADP PUNCT ADV ADV ADJ NOUN AUX VERB ADP NOUN PUNCT
RT @USER2085 : Do n't mix ur words wid ur Mood coz u have many options to change ur mood but u never get any option to replace ur spoken w \u2026	X X PUNCT AUX PART VERB PRON NOUN NOUN PRON NOUN X PRON VERB ADJ NOUN PART VERB PRON NOUN CCONJ PRON ADV VERB DET NOUN PART VERB PRON VERB ADP PUNCT
@USER2299 Nikki no , you \u2019re better than that	PROPN NOUN DET PUNCT PRON AUX ADJ ADP PRON
RT @USER561 : Trump \ does n\u2019t care who gets hurt as long as he makes a profit off it . That can not be the person who leads the United S \u2026	X X PUNCT PROPN PUNCT AUX PART VERB PRON VERB VERB ADV ADJ SCONJ PRON VERB DET NOUN ADP PRON PUNCT PRON AUX PART AUX DET NOUN PRON VERB DET PROPN PROPN PUNCT
RT @USER206 : I have a good heart ... but this attitude	X X PUNCT PRON VERB DET ADJ NOUN PUNCT CCONJ DET NOUN
\ How are you \ \ Fucking awful or did you want me to lie and say good how are you ? \ URL569	PUNCT ADV AUX PRON PUNCT PUNCT VERB ADJ CCONJ VERB PRON VERB PRON PART VERB CCONJ VERB ADJ ADV AUX PRON PUNCT PUNCT X
@USER2335 You \u2019re on the list ! We \u2019re on our way with Red Bull to help you through your workday .	VERB PRON VERB ADP DET NOUN PUNCT PRON VERB ADP PRON NOUN ADP PROPN NOUN PART VERB PRON ADP PRON NOUN PUNCT
@USER533 @USER949 some females do n't care as long as they get all the attention . That ai n't me tho	NOUN VERB DET NOUN AUX PART VERB ADV ADJ SCONJ PRON VERB DET DET NOUN PUNCT PRON AUX PART PRON ADV
@USER1706 cmon now . That 's bro	PROPN NOUN ADV PUNCT PRON AUX NOUN
RT @USER1453 : Was all of this legal ? URL1244	X X PUNCT ADV DET ADP DET NOUN PUNCT X
RT @USER201 : 14th Feb 2015 : World Cup first match 14th Feb 2016 : Ind vs SL T20 Cricket lovers have a reason to Celebrate Valentine \u2026	X X PUNCT X X NUM PUNCT PROPN NOUN ADJ NOUN NOUN X NUM PUNCT NOUN ADP PROPN X X NOUN VERB DET NOUN ADP NOUN NOUN PUNCT
RT @USER1468 : Season ticket renewed . Thanks to all that walked out last season to keep the prices down . @USER1245 @USER2473 \ud83d\udc4a\ud83c\udffb	X X PUNCT NOUN NOUN VERB PUNCT NOUN ADP DET DET NOUN ADP ADJ NOUN PART VERB DET NOUN ADV PUNCT X X X
RT @USER2360 : 2ne1 will forever be my favorite girl group \ud83d\udc95 #7YearsWith2NE1 URL1202	X X PUNCT NOUN AUX ADV AUX PRON ADJ NOUN NOUN X X X
RT @USER2644 : @USER493 Do you miss those days ? URL522	X X PUNCT NOUN AUX PRON VERB PRON NOUN PUNCT X
RT @USER1052 : To all those it does n't matter to because they 'll be dead soon anyway - how about ticking the the remain box for those w \u2026	X X PUNCT ADP DET PRON PRON AUX PART VERB PART SCONJ PRON AUX AUX ADJ ADV ADV PUNCT ADV ADP VERB DET DET NOUN NOUN ADP PRON NOUN PUNCT
I 'm not difficult I 'm just about my business !	PRON AUX PART ADJ PRON AUX ADV ADP PRON NOUN PUNCT
@USER242 yea ca n't \ud83d\ude14	PROPN INTJ AUX PART ADJ
Please shit the suck up	INTJ NOUN DET NOUN ADP
@USER425 < Kira is committing a crime himself . Everyone commits crimes , even the ones who keep crimes from being done . \ L pressed >	NOUN PUNCT NOUN AUX VERB DET NOUN PRON PUNCT ADV NOUN NOUN PUNCT ADV DET NOUN PRON VERB NOUN ADP AUX ADJ PUNCT PUNCT PROPN NOUN PUNCT
Lake Wind Advisory in effect from 9 AM for Angelina , Cherokee , Nacogdoches , Sabine and San Augustine Counties #txwx URL1304	PROPN NOUN NOUN ADP NOUN ADP NUM NOUN ADP NOUN PUNCT NOUN PUNCT NOUN PUNCT NOUN CCONJ PROPN NOUN X X X
RT @USER98 : The #GRAMMYs red carpet will last for about another 2 / 3 hours . Ariana could come late , we 'll see .	X X PUNCT DET NOUN ADJ NOUN AUX VERB ADP ADP DET NUM PUNCT NUM NOUN PUNCT NOUN AUX VERB ADJ PUNCT PRON AUX VERB PUNCT
Treat me like a queen , buy me CERTAIN things , just show me how life pose to be \ud83d\ude0f\ud83d\udc4c\ud83c\udffe	VERB PRON ADP DET NOUN PUNCT VERB PRON VERB NOUN PUNCT ADV VERB PRON ADV NOUN NOUN PART AUX X
#LokerEvent Web Designer URL1001	NOUN NOUN ADV NOUN
I do n't think i really have a type , I think a type has me . All the same guys come for me \ud83e\udd14	PRON AUX PART VERB PRON ADV VERB DET NOUN PUNCT PRON VERB DET NOUN VERB PRON PUNCT DET DET ADJ NOUN VERB ADP PRON SYM
Arts L1	NOUN NOUN
' Repair Matters ' group hopes to empower people with fix it skills URL550	PUNCT NOUN NOUN PUNCT NOUN NOUN PART NOUN NOUN ADP NOUN PRON NOUN X
@USER2073 @USER1698 Congratulations on being front page news !	PROPN NOUN NOUN ADP AUX ADJ NOUN NOUN PUNCT
@USER2274 Hhhahahh just take number 12 Then \ud83d\ude02\ud83d\ude02	NOUN NOUN ADV VERB NOUN NUM ADV SYM
RT @USER896 : Chris Brown started the trend of freestyle dancing to \ young thug / future / rich homie quan \ songs during his concerts . I see \u2026	X X PUNCT PROPN PROPN VERB DET NOUN ADP NOUN NOUN ADP PUNCT ADJ NOUN PUNCT NOUN PUNCT ADJ NOUN NOUN PUNCT NOUN ADP PRON NOUN PUNCT PRON VERB PUNCT
RT @USER467 : Marcus Rashford dribbled past 3 players v #ISL . No player on the pitch managed more . He played for 5 f**king minutes . \u2026	X X PUNCT NOUN X VERB ADV NUM NOUN PROPN NOUN PUNCT DET NOUN ADP DET NOUN NOUN ADV PUNCT PRON NOUN ADP NUM NOUN NOUN PUNCT PUNCT
Mf what ? URL619	VERB PRON PUNCT X
RT @USER10 : Indianapolis wicked wicked wicked vibes .. purple reign fanatics \u2614\ufe0f love forever	X X PUNCT X X X X X PUNCT ADJ NOUN X X VERB ADV
@USER86 @USER979 such a basic but difficult mission .	NOUN NOUN DET DET NOUN CCONJ ADJ NOUN PUNCT
Lol girls are funny	INTJ NOUN AUX ADJ
I am streaming on #BIGOLIVE . Join now ! URL764 URL284	PRON AUX VERB ADP NOUN PUNCT VERB ADV PUNCT X X
@USER1109 @USER538 @USER266 I have not . Should I ? URL1098	PROPN NOUN NOUN PRON VERB ADV PUNCT AUX PRON PUNCT X
@USER2569 thank you :)	PROPN VERB PRON SYM
RT @USER472 : Me : I 'm really tryin to save money Friends : let 's all go out to eat Me : URL1299	X X PUNCT PRON PUNCT PRON AUX ADV VERB PART VERB NOUN NOUN PUNCT VERB PART DET VERB ADP PART VERB PRON PUNCT X
RT @USER1584 : \ I 'm always having to look over my shoulder . \ Why we 're still talking about racism : URL599	X X PUNCT PUNCT PRON AUX ADV VERB PART VERB ADP PRON NOUN PUNCT PUNCT ADV PRON AUX ADV VERB ADP NOUN PUNCT X
can someone get me gars i have the money lol	AUX PRON VERB PRON NOUN PRON VERB DET NOUN INTJ
RT @USER1753 : No lie GSU was lit on this night #GSU #StateNotSouthern URL368	X X PUNCT DET VERB NOUN AUX ADJ ADP DET NOUN X X X
RT @USER295 : Senegal 's Lake Retba owes its pink color to the presence of carotenoids produced by an algae . #Senegal #funfacts URL221 \u2026	X X PUNCT NOUN PART PROPN NOUN VERB PRON ADJ NOUN ADP DET NOUN ADP NOUN NOUN ADP DET NOUN PUNCT X X X PUNCT
@USER166 remove the words \ with men on base \	NOUN VERB DET NOUN PUNCT ADP NOUN ADP NOUN PUNCT
Revealed Radio 070 - The Chainsmokers and Hardwell URL1042 \ud83d\udd25\ud83d\ude4c\ud83d\udc4f	NOUN NOUN NOUN PUNCT DET NOUN CCONJ NOUN X X
Got these beauties today from @USER124 \ud83c\udf19\ud83d\udc8b URL315	VERB DET NOUN NOUN ADP PROPN X X
RT @USER1192 : drunk texts are cute because while their mind is n't functioning correctly , you 're still on it	X X PUNCT NOUN NOUN AUX ADJ SCONJ SCONJ PRON NOUN AUX PART NOUN NOUN PUNCT PRON AUX ADV ADP PRON
I 'm artistic you niggas are autistic retarted \ud83d\ude44	PRON AUX VERB PRON NOUN AUX ADJ X X
RT @USER1761 : Bad habit : staying up all night thinking about someone whos probably thinking about som \u2026	X X PUNCT ADJ NOUN PUNCT VERB ADP DET NOUN VERB ADP PRON NOUN ADV VERB ADP NOUN PUNCT
Great chance to nominate the best & brightest from our AMC community ! URL1351 #assnchat #assnprofs	ADJ NOUN PART VERB DET ADJ CCONJ ADJ ADP PRON PROPN NOUN PUNCT X X X
Your Local Doppler Radar URL891 #roundrock	PRON NOUN NOUN X X X
RT @USER1625 : 68 . my girl getting all dolled up \ud83d\ude0d URL1113	X X PUNCT NOUN PUNCT PRON NOUN VERB DET NOUN ADP SYM X
Just posted a photo URL1284	ADV VERB DET NOUN X
\ud83d\udcf7 Purchase my special edition of Alternative Revolution Magazine at URL748 URL888	PROPN VERB PRON ADJ NOUN ADP NOUN NOUN PROPN ADP NOUN X
RT @USER1005 : She is on another level \ud83d\ude0d URL586	X X PUNCT PRON AUX ADP DET NOUN SYM X
I 'm craving the parlor soooo bad	PRON AUX VERB DET NOUN NOUN ADJ
@USER2636 i m only 65 days from taking over	PROPN PRON AUX ADV NOUN NOUN ADP VERB ADP
imagine being able to budget that must be so nice	ADV AUX VERB PART VERB PRON AUX AUX ADV ADJ
A3174 [ NEW ] Authorizes special striped bass license plate . URL879	NOUN PUNCT ADJ PUNCT X ADJ NOUN X X X PUNCT X
@USER2627 is so nice to me on Twitter but so mean on Instagram ??	NOUN AUX ADV ADJ ADP PRON ADP PROPN CCONJ ADV VERB ADP PROPN PUNCT
@USER1699 @USER843 POSSIBLEEEEEE , POSSILBEEEEEEEEEEEEEEEE . * chants \ cousins \ over and over again *	PROPN NOUN NOUN PUNCT NOUN PUNCT PUNCT NOUN PUNCT NOUN PUNCT ADV CCONJ ADV ADV PUNCT
He looks at me !! @USER1200 URL340	PRON VERB ADP PRON PUNCT X X
Yamaha \u2019s Rossi gets contract extension through 2018 : Valentino Rossi has extended his contract with Yamaha for ... URL849	NOUN PART NOUN VERB NOUN NOUN ADP NUM PUNCT X NOUN AUX VERB PRON NOUN ADP NOUN ADP PUNCT X
RT @USER326 : Gucci Mane is going on tour after being released from prison in September URL791	X X PUNCT NOUN NOUN AUX VERB ADP NOUN SCONJ AUX NOUN ADP NOUN ADP NOUN X
RT @USER702 : ' Jesus please mention my name when you talk to your Father today ... ' \ud83d\ude4f\ud83c\udffd	X X PUNCT PUNCT PROPN INTJ VERB PRON NOUN ADV PRON VERB ADP PRON NOUN NOUN PUNCT PUNCT X
@USER468 good , now they 'll make their own money and wo n't have to charge men for love . URL454	PROPN ADJ PUNCT ADV PRON AUX VERB PRON ADJ NOUN CCONJ AUX PART VERB PART VERB NOUN ADP NOUN PUNCT X
RT @USER451 : Naruto : Hey let 's go get some ramen !! Sasuke : shut up and get off my lawn , loser Itachi : now now Sasuke be nice URL221 \u2026	X X PUNCT X PUNCT INTJ VERB PART VERB VERB DET NOUN PUNCT X PUNCT VERB ADP CCONJ VERB ADP PRON NOUN PUNCT X X PUNCT ADV ADV NOUN AUX ADJ X PUNCT
BETFAIR - Bet \u00a3 10 Get \u00a3 30 + Double Winnings on Everton v Man Utd if both teams score URL242 #FACup URL1139	NOUN PUNCT NOUN SYM NUM VERB SYM NUM SYM NOUN NOUN ADP NOUN PROPN NOUN NOUN SCONJ DET NOUN X X X X
RT @USER259 : Swervin thru my ends	X X PUNCT X X PRON NOUN
Taylor Swift \u2018s boyfriend Calvin Harris Injured In a Terrible Car Accident URL625 URL1436	PROPN PROPN PROPN NOUN PROPN NOUN VERB ADP DET NOUN NOUN NOUN X X
what song -	PRON NOUN PUNCT
RT @USER139 : The first \ haters will say it 's fake \ video to make me laugh \ud83d\ude02 URL911	X X PUNCT DET ADJ PUNCT NOUN AUX VERB PRON AUX ADJ PUNCT NOUN PART VERB PRON VERB SYM X
RT @USER478 : CHAMPIONS !!!! URL1377	X X PUNCT NOUN PUNCT X
RT @USER2501 : ( credits to blackangel94a on tumblr ) URL1577	X X PUNCT PUNCT NOUN ADP NOUN ADP NOUN PUNCT X
RT @USER2052 : qn : which artist do you want to collab with the most ? hansol : Any URL1628	X X PUNCT NOUN PUNCT DET NOUN AUX PRON VERB PART VERB ADP DET ADJ PUNCT X PUNCT DET NOUN
@USER2460 Me too . Looking forward to the delivery tomorrow .	VERB PRON ADV PUNCT VERB ADV ADP DET NOUN NOUN PUNCT
It s a legit hustle URL408	PRON AUX DET NOUN NOUN X
RT @USER1425 : The UNCOMFORTABLE CONVERSATIONS series starts today !!! Make sure your there !!! @ LTB 5 , 6 - 8 PM . URL1048	X X PUNCT DET NOUN NOUN NOUN VERB NOUN PUNCT VERB ADJ PRON ADV PUNCT ADP NOUN NUM PUNCT NUM PUNCT NUM NOUN PUNCT X
'Cause I 'm as free as a bird now	PROPN PRON AUX ADV ADJ ADP DET NOUN ADV
Oh goddam nit I cried at work again	INTJ NOUN VERB PRON VERB ADP NOUN ADV
RT @USER2453 : @USER1838 good evening ! ( japan time ) ! Thank you very much ! Friendly Corina Dumitrescu 's ! Nature is Beautiful ! spen \u2026	X X PUNCT VERB ADJ NOUN PUNCT PUNCT NOUN NOUN PUNCT PUNCT VERB PRON ADV ADV PUNCT ADJ NOUN X PART PUNCT NOUN AUX ADJ PUNCT X PUNCT
Joebarly Feat. HitMaker Q \u2013 Widd It URL1474 Major #HipHop	NOUN PROPN NOUN NOUN PUNCT VERB PRON NOUN ADJ NOUN
... Do n't look at me like that . You and I both know there 's nothing I can do .	PUNCT AUX PART VERB ADP PRON ADP PRON PUNCT PRON CCONJ PRON VERB VERB PRON AUX PRON PRON AUX VERB PUNCT
All I did was unpack my shoes / purses ... I feel like I unpacked a whole damn house \ud83d\ude28\ud83d\ude16	DET PRON AUX AUX VERB PRON NOUN PUNCT NOUN PUNCT PRON VERB SCONJ PRON VERB DET ADJ ADJ NOUN X
@USER1927 thank you for making sure that is exactly what is going to happen . #ARSAVL	PROPN VERB PRON ADP VERB ADJ PRON AUX ADV PRON AUX VERB PART VERB PUNCT X
Get Lost Moon for FREE on URL358 - your weekly game #giveaway #orlygift #steam #indi	VERB NOUN NOUN ADP ADJ ADP NOUN PUNCT PRON NOUN NOUN NOUN X X X
RT @USER2284 : #Housing Shortages Stifle Sales Contracts URL1476 - more from @USER2379 #realestate #phs URL224 \u2026	X X PUNCT X X X NOUN NOUN NOUN PUNCT ADJ ADP NOUN X X X PUNCT
lowkey obsessed with me before you	NOUN NOUN ADP PRON SCONJ PRON
#DolceAmorePuSo TWEET BOOST ! NOW TRENDING ! DOLCE AMORE lsmlm	PROPN VERB NOUN PUNCT ADV NOUN PUNCT X X X
RT @USER1131 : Omg I 'm at this youtube party and these people write first impression judgments of you LOL @USER1327 URL1086 \u2026	X X PUNCT INTJ PRON AUX ADP DET NOUN NOUN CCONJ DET NOUN VERB ADJ NOUN NOUN ADP PRON INTJ X X PUNCT
RT @USER2171 : To love someone is to see a miracle invisible to others . #ALDUBSeeYouSoon	X X PUNCT PART VERB PRON AUX PART VERB DET NOUN NOUN ADP NOUN PUNCT X
RT @USER1618 : This how you need to be thinking girls . URL500	X X PUNCT PRON ADV PRON VERB PART AUX VERB NOUN PUNCT X
RT @USER2272 : Most subscribed music artists on YouTube : # 1 Justin Bieber # 2 Rihanna # 3 One Direction # 4 Taylor Swift URL852 \u2026	X X PUNCT ADJ NOUN NOUN NOUN ADP NOUN PUNCT NOUN NUM PROPN PROPN NOUN NUM PROPN NOUN NUM NUM NOUN NOUN NUM PROPN PROPN X PUNCT
RT @USER1778 : 10 Worst Feelings : Cheated on Over thinking Lied to Heart broken Not cared for Losing Scared Assuming Nervous Letting go	X X PUNCT NUM ADJ NOUN PUNCT VERB ADP ADV VERB VERB ADP NOUN NOUN PART VERB ADP VERB ADJ VERB ADJ VERB VERB
RT @USER817 : The \ Laugh at me one more time \ starter pack URL357	X X PUNCT DET PUNCT NOUN ADP PRON NUM ADJ NOUN PUNCT X NOUN X
Jessica watched @USER980 and his schemy little smirk before she rolled her hazel hues at his response . \ I 'm glad I got your ~~	PROPN VERB NOUN CCONJ PRON NOUN ADJ NOUN SCONJ PRON VERB PRON NOUN NOUN ADP PRON NOUN PUNCT PUNCT PRON AUX ADJ PRON VERB PRON NOUN
RT @USER1340 : I 'm the type of person to never get any sleep because all I do each night is overthink the smallest shit that shouldn ' \u2026	X X PUNCT PRON AUX DET NOUN ADP NOUN PART ADV VERB DET NOUN SCONJ DET PRON VERB DET NOUN AUX VERB DET NOUN NOUN PRON NOUN PUNCT PUNCT
RT @USER1413 : Ever eaten a banana with black spots ? This is what they 're doing to you : URL873	X X PUNCT ADV VERB DET NOUN ADP ADJ NOUN PUNCT PRON AUX PRON PRON AUX VERB ADP PRON PUNCT X
The Wrong Trousers #CowellsChildrensTitles	DET ADJ NOUN X
RT @USER2406 : Leigh Anne Pinnock URL1494	X X PUNCT X X X X
RT @USER1988 : There is a difference between intuition & fear they both can serve as guides , but only the intuition feels comfortable	X X PUNCT PRON AUX DET NOUN ADP NOUN CCONJ NOUN PRON ADV AUX VERB ADP NOUN PUNCT CCONJ ADV DET NOUN VERB ADJ
RT @USER383 : What ? You expect her to wear a suit at the beach ? URL1586	X X PUNCT PRON PUNCT PRON VERB PRON PART VERB DET NOUN ADP DET NOUN PUNCT X
RT @USER1634 : We want a #newsarunshow with @USER138 #BarunSobti & #SanayaIrani ( #Sarun ) on @USER1250 @USER1950 URL224 \u2026	X X PUNCT PRON VERB DET NOUN ADP NOUN NOUN CCONJ NOUN PUNCT NOUN PUNCT ADP NOUN X X PUNCT
RT @USER2376 : every morning is a continuous cycle of wow i ca n't wait to go to bed tonight	X X PUNCT DET NOUN AUX DET NOUN NOUN ADP INTJ PRON AUX PART VERB PART VERB ADP NOUN NOUN
1,000,000 Real YouTube Views , $ 2000 !! URL524	NOUN ADJ NOUN NOUN PUNCT SYM NOUN PUNCT X
RT @USER1755 : Beer Director Greg Engert getting ready to taste some springtime brews on @USER1704 !	X X PUNCT NOUN PROPN NOUN NOUN VERB ADJ PART VERB DET NOUN NOUN ADP NOUN PUNCT
RT @USER916 : Found some cool fans at the @USER760 display who have NO idea I 'm about to surprise them w/ pre-race passes ! \ud83c\udf89 - JW URL0 \u2026	X X PUNCT VERB DET ADJ NOUN ADP DET NOUN NOUN PRON VERB DET NOUN PRON AUX ADP PART VERB PRON VERB NOUN NOUN PUNCT X PUNCT X X PUNCT
RT @USER1960 : Uncountable ! #ServicesByMSG . Are going Onn Across The Globe under HIS HOLINESS @USER530 ' :-) URL1360	X X PUNCT NOUN PUNCT NOUN PUNCT AUX VERB NOUN X DET NOUN NOUN PRON NOUN X PUNCT SYM X
RT @USER291 : I love this cat . URL1120	X X PUNCT PRON VERB DET NOUN PUNCT X
#VeranoMTV2016 5 Seconds of Summer 16	NOUN NUM NOUN ADP NOUN NUM
RT @USER2282 : HARRY IS STRONG BUT CA N'T EVEN OPEN A BAG OF GOLDFISH URL389	X X PUNCT NOUN AUX NOUN CCONJ PROPN AUX VERB ADP DET NOUN ADP NOUN X
North Ends getting a theatre \ud83e\udd18\ud83c\udffb\ud83d\ude0d URL819	PROPN ADV VERB DET NOUN NOUN X
RT @USER2394 : 26 . dick and dom in da bungalow they were just discount ant and dec but i loved it anyway URL1270	X X PUNCT NUM PUNCT NOUN CCONJ NOUN ADP DET NOUN PRON AUX ADV NOUN NOUN CCONJ NOUN CCONJ PRON VERB PRON ADV X
k but @USER2313 is legit cute af so I 'm confused \ud83d\ude29	NUM CCONJ NOUN AUX NOUN ADJ NOUN ADV PRON AUX ADJ SYM
#pray Jehovah Sabaoth restore Jamaican lady 's privacy Completely & vindicate her sanity & reports of thugs ' 24 hr stalking & eavesdroppin IJN	PROPN PROPN NOUN X X NOUN PART NOUN ADV CCONJ VERB PRON NOUN CCONJ NOUN ADP NOUN PUNCT NUM NOUN X CCONJ X X
Like 8 hours ago URL1579	VERB NUM NOUN ADV X
Why are you turning on me ???	ADV AUX PRON VERB ADP PRON PUNCT
RT @USER1402 : This is a real fight URL609	X X PUNCT PRON AUX DET ADJ NOUN X
RT @USER2510 : Chelsea owner Roman Abramovich having second thoughts about Jose ... URL723 #Pep_Guardiola #Jose_Mourinho	X X PUNCT PROPN NOUN NOUN NOUN VERB ADJ NOUN ADP PROPN PUNCT X X X
Wife Catches Her Husband With Mistress And Beats The Hell Out Of Her ( Photos ) URL627	NOUN VERB PRON NOUN ADP NOUN CCONJ VERB DET NOUN ADP ADP PRON PUNCT NOUN PUNCT X
Time to Make your #MomentsThatCount at #NissanPavilion by having a glimpse of ICC T20 trophy watch here >>> URL1604	NOUN PART VERB PRON NOUN ADP NOUN ADP VERB DET NOUN ADP PROPN NOUN NOUN VERB ADV X X
WWW #MTVHottest Little Mix	ADJ NOUN NOUN NOUN
Our brand new Moon Babe with hair buns in the beauteous home of @USER1630 | Available \u2026 URL1186	PRON NOUN ADJ NOUN NOUN ADP NOUN NOUN ADP DET NOUN NOUN ADP NOUN SYM ADJ PUNCT X
\ud83d\udc49 URL501 \ud83d\udc48 Real women to sex with \u2705 Fully free now \ud83d\udd1e #anikka #angelina #analporn #animation	NOUN NOUN NOUN ADJ NOUN ADP NOUN ADP NOUN NOUN ADJ ADV X X X X X
I got a traveler insta it 's fr just pictures I 've shot while traveling n exploring do n't have to follow me but just take a peek ig : stevoohhh	PRON VERB DET NOUN NOUN PRON AUX ADJ ADV NOUN PRON AUX NOUN SCONJ NOUN CCONJ NOUN AUX PART VERB PART VERB PRON CCONJ ADV VERB DET NOUN NOUN PUNCT X
Tory Lanez - Say It URL479 #hiphop #music #Verified #rt	NOUN NOUN PUNCT VERB PRON NOUN X X X X
RT @USER597 : R\u00e9sum\u00e9 : Makes $ 35 k a year but will break your kindergartner 's ankles URL573	X X PUNCT NOUN PUNCT VERB SYM NOUN X DET NOUN CCONJ AUX VERB PRON NOUN PART NOUN X
themselves as russian URL782	PRON ADP NOUN X
@USER402 makeup revolution basically dupes high end makeup it 's where I get all my stuff lmao	PROPN NOUN NOUN ADV NOUN ADJ NOUN NOUN PRON AUX ADV PRON VERB DET PRON NOUN INTJ
RT @USER2206 : when the people you thought are quiet pero dili diay orayt URL760	X X PUNCT ADV DET NOUN PRON VERB AUX ADJ NOUN X X X X
RT @USER1589 : Me Myself and I by G Eazy | Cover by Alex Aiono : URL361 via @USER1490	X X PUNCT PRON PRON CCONJ PRON ADP PROPN NOUN SYM PROPN ADP PROPN NOUN PUNCT X ADP PROPN
@USER500 haha that 's so cool !! I plan on getting a cap shield eventually when I have money to blow . Tweet a pic of the suit !!	PROPN INTJ PRON AUX ADV ADJ PUNCT PRON VERB ADP VERB DET NOUN NOUN NOUN ADV PRON VERB NOUN ADP VERB PUNCT VERB DET NOUN ADP DET NOUN PUNCT
BJ the Chicago Kid Talks Kendrick Lamar & Repping the ' New R&B ' on Motown Debut Album : Moving to Los Angeles a ... URL772	VERB DET PROPN NOUN PROPN NOUN NOUN CCONJ VERB DET PUNCT ADJ PROPN PUNCT ADP NOUN X NOUN PUNCT VERB ADP PROPN NOUN DET PUNCT X
@USER2150 @USER2103 I need to check this out ! Thanks #saskedchat	PROPN VERB PRON VERB PART VERB PRON ADV PUNCT NOUN X
RT @USER2231 : We are live now !!!! URL1389 URL1033	X X PUNCT PRON AUX VERB ADV PUNCT X X
RT @USER2409 : #KanhaiyaKumar bail plea #adjourned to Feb. 29 URL814 URL443	X X PUNCT X X X X ADP NUM NUM X X
RT @USER1443 : \ Can i have a bite \ Me : URL1243	X X PUNCT PUNCT AUX PRON VERB DET NOUN PUNCT PRON PUNCT X
RT @USER128 : Look at that face . The joys of being a parent URL730	X X PUNCT VERB ADP DET NOUN PUNCT DET NOUN ADP AUX DET NOUN X
RT @USER2590 : in the mood for a long drive with no destination	X X PUNCT ADP DET NOUN ADP DET ADJ NOUN ADP DET NOUN
RT @USER161 : throwback to this amazing performance URL1108	X X PUNCT NOUN ADP PRON ADJ NOUN X
RT @USER1713 : I find this hilarious in its appalling-ness for a number of reasons . URL1358	X X PUNCT PRON VERB PRON ADJ ADP DET NOUN ADP DET NOUN ADP NOUN PUNCT X
RT @USER1527 : Very hot ! URL423	X X PUNCT ADJ ADJ PUNCT X
RT @USER959 : #NewportNews #Virginia boy leaves Gatorade , water for #LetterCarrier URL938 via @USER6 URL224 \u2026	X X PUNCT NOUN NOUN NOUN VERB NOUN PUNCT NOUN ADP NOUN NOUN ADP X X PUNCT
The old niggas on Dr Dre album Lowkey be taking hella shots at the new niggas lol	DET ADJ NOUN ADP PROPN NOUN NOUN NOUN AUX VERB ADV NOUN ADP DET ADJ NOUN INTJ
RT @USER1874 : hi a lil reminder that u guys will meet dan & phil :~) URL1169	X X PUNCT INTJ DET ADJ NOUN SCONJ PRON NOUN AUX VERB NOUN CCONJ X X X
Egyptian writer Ahmed Naji \u2019s crime is n't what he wrote \u2013 it is that he is alive URL607	PROPN PROPN NOUN NOUN PART NOUN AUX PART PRON PRON VERB PUNCT PRON AUX SCONJ PRON AUX ADJ X
RT @USER919 : Great setting for @USER1033 Falmouth GP of the Sea 2017 URL461	X X PUNCT ADJ NOUN ADP NOUN NOUN X ADP DET NOUN NUM X
RT @USER1916 : hate getting flashbacks from things you do n't want to remember . it feels like your heart suddenly drops and anxiety starts \u2026	X X PUNCT VERB VERB NOUN ADP NOUN PRON AUX PART VERB PART VERB PUNCT PRON VERB ADP PRON NOUN NOUN NOUN CCONJ NOUN VERB PUNCT
RT @USER1256 : \ We need some payday lending reforms . \ - Alabama Banking Department Superintendent John Harrison URL1181 \u2026	X X PUNCT PUNCT PRON VERB DET NOUN NOUN NOUN PUNCT PUNCT PUNCT X X X X PROPN X X PUNCT
RT @USER2347 : For the highest ticket prices in world football , we 're ' entitled ' to expect more than zero PL / CL titles in 12 yrs . URL219 \u2026	X X PUNCT ADP DET NOUN NOUN NOUN ADP NOUN NOUN PUNCT PRON AUX PUNCT NOUN PUNCT PART VERB ADJ ADP NUM NOUN PUNCT NOUN NOUN ADP NUM NOUN PUNCT X PUNCT
Now playing on OSN Radio ( @USER2325 ) Another Day ( Perfecto Mix ) by Skip Raiders #OSN #NowPlaying ( URL1112 )	ADV VERB ADP NOUN NOUN PUNCT NOUN PUNCT DET NOUN PUNCT NOUN NOUN PUNCT ADP PROPN X X X PUNCT X PUNCT
@USER2322 what	VERB PRON
Of course , as everyone knows Powers resigned from the campaign and retracted these comments . But now she 's US Ambassador to the UN .	ADP ADV PUNCT SCONJ PRON VERB NOUN NOUN ADP DET NOUN CCONJ NOUN DET NOUN PUNCT CCONJ ADV PRON AUX PROPN NOUN ADP DET NOUN PUNCT
ugh I 'm so picky when it comes to dress shopping :(	INTJ PRON AUX ADV NOUN ADV PRON VERB PART VERB NOUN SYM
the video had an effect on me	DET NOUN VERB DET NOUN ADP PRON
Oh , and regex by @USER1783 . Do check out the slides . #NICAR16	INTJ PUNCT CCONJ NOUN ADP NOUN PUNCT AUX VERB ADP DET NOUN PUNCT X
can hou shut up beacause yiur beeath stinka URL1440	AUX VERB VERB ADP NOUN X X X X
I just do n't understand how someone can change their mind so fast . You 're so disgusting	PRON ADV AUX PART VERB ADV PRON AUX VERB PRON NOUN ADV ADJ PUNCT PRON AUX ADV X
Genocide in #Yemen yet world silence . Very strange : for US & #Europe , Yemen does n't exist ! Can You explain ? #ForgottenWarInYemen	NOUN ADP NOUN ADV NOUN NOUN PUNCT ADJ NOUN PUNCT ADP PROPN CCONJ NOUN PUNCT NOUN AUX PART VERB PUNCT AUX PRON VERB PUNCT X
Jason Jordan just threw a dude	PROPN PROPN ADV VERB DET NOUN
If you cheat on someone that is willing to do anything for you , you actually cheated yourself out of true loyalty .	SCONJ PRON VERB ADP PRON PRON AUX NOUN PART VERB PRON ADP PRON PUNCT PRON ADV VERB PRON ADP ADP ADJ NOUN PUNCT
RT @USER1289 : FRIENDLY REMINDER THAT STILES STILINSKI AND ALLISON ARGENT DESERVED MORE SCENES TOGETHER URL905	X X PUNCT ADJ NOUN PRON NOUN NOUN CCONJ NOUN X X ADV NOUN X X
.... and guess who are paying the shortfall ! URL875	PUNCT CCONJ INTJ PRON AUX VERB DET NOUN PUNCT X
RT @USER849 : TWITTER TEAM DOING PABEBE WAVE with @USER2199 STANDEE #VoteMaineFPP #KCA URL651	X X PUNCT X X X X X ADP PROPN X X X X
She wrote on a note attached \ I do nt put my credit card info on the internet \ \ud83d\ude2d\ud83d\ude02\ud83d\ude2d\ud83d\ude02 I love her old ass man .	PRON VERB ADP DET NOUN NOUN PUNCT PRON AUX PART VERB PRON NOUN NOUN NOUN ADP DET NOUN PUNCT X PRON VERB PRON ADJ NOUN NOUN PUNCT
RT @USER804 : not moving no nigga in my house , if ima do bad , ima do bad by my damn self !!! \ud83d\udc4f\ud83c\udffe	X X PUNCT PART VERB DET NOUN ADP PRON NOUN PUNCT SCONJ VERB VERB ADJ PUNCT VERB VERB ADJ ADP PRON ADJ NOUN PUNCT X
RT @USER1550 : \u201c Current mood and most of the days mood . \u201c URL695	X X PUNCT PUNCT NOUN NOUN CCONJ ADJ ADP DET NOUN NOUN PUNCT PUNCT X
RT @USER548 : As far as I 'm aware , the doors are open . And we 're On The Road Again .	X X PUNCT ADV ADV SCONJ PRON AUX NOUN PUNCT DET NOUN AUX ADJ PUNCT CCONJ PRON AUX ADP DET NOUN NOUN PUNCT
@USER1359 what about a drink of liquid nitrogen ?	VERB PRON ADP DET NOUN ADP NOUN NOUN PUNCT
RT @USER573 : Angela Eagle : I went to Uni thanks to a Labour Govt Govt when Angela Eagle went to Uni : Thatcher ( Graduated in 1983 , St \u2026	X X PUNCT X X PUNCT PRON VERB PART NOUN NOUN ADP DET NOUN NOUN X ADV NOUN NOUN VERB ADP NOUN PUNCT NOUN PUNCT NOUN ADP NOUN PUNCT PROPN PUNCT
Sames URL1428	NOUN NOUN
RT @USER399 : .. rabbits in there . Told me they were mine to love and care for . Even hired this guy to help me feed em and clean the pen . Be \u2026	X X PUNCT PUNCT NOUN ADP ADV PUNCT VERB PRON PRON AUX PRON ADP NOUN CCONJ NOUN ADP PUNCT ADV VERB DET NOUN PART VERB PRON VERB PRON CCONJ ADJ DET NOUN PUNCT AUX PUNCT
@USER2275 Careful with that porcelain skin . sweetie !	NOUN NOUN ADP DET NOUN NOUN PUNCT NOUN PUNCT
RT @USER474 : Character progression through all 10 seasons of Friends ... URL378	X X PUNCT NOUN VERB ADP DET NUM NOUN ADP NOUN PUNCT X
RT @USER905 : rt if you grew up on these streets URL1061	X X PUNCT VERB SCONJ PRON VERB ADP ADP DET NOUN X
RT @USER213 : Funding legal services focus of AG \u2019s pre-election debate URL513 via @USER2151	X X PUNCT X X X VERB ADP NOUN PART NOUN X X ADP X
RT @USER1172 : I agree with and support President Putin ! He 's right . URL1329	X X PUNCT PRON VERB ADP CCONJ NOUN PROPN NOUN PUNCT PRON AUX ADV PUNCT X
RT @USER689 : This is perhaps the most succinct and accurate sentence regarding Trumps ' popularity I have ever read . URL1157 \u2026	X X PUNCT PRON AUX VERB DET ADJ NOUN CCONJ ADJ NOUN X X PUNCT X PRON VERB ADV VERB PUNCT X PUNCT
See you again #TSOUAwkward	VERB PRON ADV X
RT @USER480 : I got a new one for you guys URL719	X X PUNCT PRON VERB DET ADJ NOUN ADP PRON NOUN X
#VOZEMPIRE : Ready to Divorce ? David Beckham Resigned From Victoria \u2019s Fashion Company URL360	NOUN PUNCT NOUN ADP NOUN PUNCT PROPN PROPN NOUN ADP NOUN PART NOUN NOUN X
If you can meditate , then you can achieve your smallest desires in life as meditation helps you shed light on every little information !	SCONJ PRON AUX VERB PUNCT ADV PRON AUX VERB PRON NOUN NOUN ADP NOUN ADP NOUN VERB PRON VERB NOUN ADP DET ADJ NOUN PUNCT
RT @USER286 : Early Bird tickets are now Sold Out !! Get your #CountryFlo passes while supplies last : URL453 URL220 \u2026	X X PUNCT ADJ PROPN NOUN AUX ADV ADP ADV PUNCT VERB PRON NOUN NOUN ADP NOUN NOUN PUNCT X X PUNCT
He said the shit stank	PRON VERB DET NOUN NOUN
RT @USER877 : and yes there are biblical references to the ' insignificance ' of women . BUT there 's just as many to our significance a \u2026	X X PUNCT CCONJ INTJ PRON AUX NOUN NOUN ADP DET PUNCT NOUN PUNCT ADP NOUN PUNCT CCONJ PRON AUX ADV ADP ADJ ADP PRON NOUN DET PUNCT
RT @USER650 : ALL THESE VIP PEEPS IN MY MENTIONS IT S LIT \ud83d\ude0d	X X PUNCT DET PRON PROPN NOUN ADP PRON NOUN PRON AUX X SYM
RT @USER1312 : we startin to bark viciously	X X PUNCT PRON VERB ADP NOUN X
RT @USER515 : \ It does n't matter how much you have . It all means nothing if you are not happy with yourself . \ Donald Duck #quotes htt \u2026	X X PUNCT PUNCT PRON AUX PART VERB ADV ADV PRON VERB PUNCT PRON DET VERB PRON SCONJ PRON AUX PART ADJ ADP PRON PUNCT PUNCT PROPN X X X PUNCT
pursuing the opposite : complain against EU red tape --> Seek EXCEPTIONAL treatment --> Get ever more red tape @USER2384 URL417	VERB DET NOUN PUNCT VERB ADP PROPN ADJ NOUN SYM X X X SYM VERB ADV ADV ADJ NOUN X X
. @USER217 explains why Lincoln 's way is the future of luxury motoring : URL1102 URL299	PUNCT PROPN PROPN ADV PROPN PART NOUN AUX DET NOUN ADP NOUN X PUNCT X X
RT @USER19 : They 're getting 1 k RTs per minute ... Start spamming if you do n't want their lead to increase . #Harmonizers #iHeartAwards \u2026	X X PUNCT PRON AUX VERB NUM NUM NOUN X X PUNCT VERB NOUN SCONJ PRON AUX PART VERB PRON VERB PART VERB PUNCT ADJ X PUNCT
Jewellery belonging to the Duchess of Windsor was auctioned today in 1987 in Geneva , raising \u00a3 31 M for medical research .	PROPN NOUN ADP DET NOUN ADP NOUN AUX ADJ NOUN ADP NOUN ADP NOUN PUNCT NOUN SYM NUM PROPN ADP ADJ NOUN PUNCT
Middle - Eastern relationships will go through the roof URL994	PROPN PUNCT NOUN NOUN AUX VERB ADP DET NOUN X
RT @USER2192 : 11 Selfies that will make you uncomfortable . URL1273 URL1530	X X PUNCT NUM NOUN PRON AUX VERB PRON NOUN PUNCT X X
#porn More free @ URL1029 No Tricks ! #gayporn #gaygif #chaturbate #gayvideo URL1477	NOUN ADJ ADJ ADP NOUN DET NOUN PUNCT X X X X X
I liked a @USER1490 video URL986 LIQUID LIPSTICKS YOU NEED !!!	PRON VERB DET PROPN NOUN X X X PRON NOUN PUNCT
Disastorus first innigs SL performed very well 2nd innings lead by 33 runs 3 wickets left for SL #ENGvSL	NOUN ADV NOUN NOUN NOUN ADV ADV ADJ NOUN VERB ADP NOUN ADP NUM NOUN VERB ADP NOUN X
@USER2482 exactly , just go ahead !!!	PROPN ADV PUNCT ADV VERB ADV PUNCT
#NowPlaying Meathook Seed URL910	X X X X
RT @USER132 : JDR did n't really address Mario Edwards being cleared ... he 's excited that Mario is part of team on the field .	X X PUNCT NOUN AUX PART ADV NOUN NOUN NOUN AUX NOUN PUNCT PRON AUX VERB DET NOUN AUX NOUN ADP NOUN ADP DET NOUN PUNCT
RT @USER2186 : chill date ideas URL419	X X PUNCT VERB NOUN NOUN X
\ Sorry I ca n't work on July 9th because everyone is leaving Hamilton & I 'm emotionally invested in their existence . \	PUNCT INTJ PRON AUX PART VERB ADP PROPN NOUN SCONJ PRON AUX VERB PROPN CCONJ PRON AUX VERB VERB ADP PRON NOUN PUNCT PUNCT
Listen to 4 - Ayo Remix Rough by Yung 4 ( fooeee ) #np on #SoundCloud URL568	VERB ADP NUM PUNCT NOUN NOUN NOUN ADP NOUN NUM PUNCT NOUN PUNCT X ADP PROPN X
RT @USER0 : YOU ARE A WITCH ! Mariah Carey 's Brother Calls Her Out For Not Helping With Dying Sister 's URL1410 URL217 \u2026	X X PUNCT PRON AUX DET NOUN PUNCT X X PART NOUN VERB PRON ADP ADP PART NOUN ADP NOUN NOUN PART NOUN X PUNCT
RT @USER2035 : JaDine Day . DNP 's First Day Gross . This Time 's First Day Gross 15 . 15M . 15M . All with 15 \ud83d\udc9c Ang saya ulitin . \ud83d\ude39 #ThisTi \u2026	X X PUNCT NOUN NOUN PUNCT X PART ADJ NOUN NOUN PUNCT DET NOUN PART ADJ NOUN NOUN NUM PUNCT NOUN PUNCT NOUN PUNCT DET ADP NUM PROPN NOUN X X PUNCT X X PUNCT
RT @USER1377 : Can we give respectability to those who want to break India ? Arun Jaitley in Rajya Sabha #AfzalDebate URL595	X X PUNCT AUX PRON VERB NOUN ADP PRON PRON VERB PART NOUN PROPN PUNCT X X ADP NOUN X X X
RT @USER785 : Hi from us @USER1759 ( excuse the insta spam ) URL980	X X PUNCT INTJ ADP PRON NOUN PUNCT VERB DET NOUN NOUN PUNCT X
RT @USER1979 : Go on URL1144 and comment a \u2764\ufe0f on any photo so I know it 's you !! URL235	X X PUNCT VERB ADP NOUN CCONJ VERB DET NOUN ADP DET NOUN ADV PRON VERB PRON AUX PRON PUNCT X
Money on my mind .. Money on my mind , so money is all I think of .	NOUN ADP PRON NOUN PUNCT NOUN ADP PRON NOUN PUNCT ADV NOUN AUX DET PRON VERB ADP PUNCT
Rattled Bangladesh run into resurgent India #IndiavsBangladesh ... #IndiavsBangladesh URL1115	NOUN NOUN VERB ADP NOUN PROPN NOUN PUNCT X X
@USER762 always here :)	NOUN ADV ADV SYM
Although your friendly nature usually puts others at ease , muc ... More for Libra URL430	SCONJ PRON NOUN NOUN NOUN VERB NOUN ADP NOUN PUNCT NOUN PUNCT ADJ ADP NOUN X
RT @USER607 : found some tires URL1025	X X PUNCT VERB DET NOUN X
if they announce dates here i will record myself bawling for your entertainment	SCONJ PRON VERB NOUN ADV PRON AUX VERB PRON VERB ADP PRON NOUN
#Mention Brett McDanel Art @USER2221 #bizitalk #uniqueart URL1345 #business	NOUN NOUN NOUN NOUN NOUN X X X X
RT @USER1910 : @USER1910 get off @USER1352 URL1376	X X PUNCT NOUN VERB ADP NOUN X
#group sex party porn anal dating URL1068	ADJ NOUN NOUN NOUN X ADV X
\ud83d\udd1e on the 13th \ud83d\ude34	NOUN ADP DET NOUN X
RT @USER1104 : Directors and CEOs from top Multinational companies meeting in a conference held at Gurugram . ( 2016 ) URL369 \u2026	X X PUNCT NOUN CCONJ VERB ADP NOUN NOUN NOUN NOUN ADP DET NOUN NOUN ADP NOUN PUNCT PUNCT NUM PUNCT X PUNCT
Do n't just be , make a difference	AUX PART ADV AUX PUNCT VERB DET NOUN
Broken Vows by English Artist Philip Calderon . Nice Canvas Art Print . Size 11 x 14 URL639 URL1110	NOUN NOUN ADP ADJ NOUN NOUN NOUN PUNCT ADJ NOUN NOUN NOUN PUNCT NOUN NUM SYM NUM X X
RT @USER1457 : Where URL978	X X PUNCT ADV NOUN
@USER1273 @USER215 be thankful it 's only 1 k ... Double or triple that for LA .	PROPN NOUN AUX VERB PRON AUX ADJ NUM NOUN PUNCT NOUN CCONJ VERB PRON ADP PROPN PUNCT
@USER1757 Your Twitterettes are doing fine .	VERB PRON NOUN AUX VERB ADJ PUNCT
basketball bitch	NOUN NOUN
You can either sit and dwell on all the negative shit ... Or you can thank god you 're alive 'n blessed !!	PRON AUX ADV VERB CCONJ NOUN ADP DET DET ADJ NOUN PUNCT CCONJ PRON AUX VERB NOUN PRON AUX ADJ NOUN NOUN PUNCT
RT @USER26 : Dio - Rainbow In The Dark !! URL1388	X X PUNCT NOUN PUNCT NOUN ADP DET NOUN PUNCT X
RT @USER482 : 3 years ago today ... The best guard of honour EVER ! #mufc URL422	X X PUNCT NUM NOUN ADV NOUN PUNCT DET ADJ NOUN ADP NOUN NOUN PUNCT X X
RT @USER1299 : Behind the scenes . Rick and Daryl #TheWalkingDead URL359	X X PUNCT VERB DET NOUN PUNCT PROPN CCONJ NOUN X X
#NowPlaying Work by Rihanna \u266b URL603	X VERB ADP PROPN SYM X
RT @USER2107 : never want to disappoint you	X X PUNCT ADV VERB PART VERB PRON
@USER1582 @USER1801 @USER1146 is logic . She leads in Alba , would connect across generations . She can also check Nic Sturgeon	PROPN NOUN NOUN AUX NOUN PUNCT PRON VERB ADP NOUN PUNCT AUX NOUN X X PUNCT PRON AUX ADV VERB NOUN X
RT @USER207 : BTS Summer Package in Dubai : Photobook , DVD , 2 mini poster , Zipperbag , Beach ball , Tattoo stickers , Charm accessory htt \u2026	X X PUNCT NOUN NOUN NOUN ADP NOUN PUNCT NOUN PUNCT NOUN PUNCT NUM PROPN NOUN PUNCT NOUN PUNCT NOUN NOUN PUNCT PROPN NOUN PUNCT X X X PUNCT
@USER2661 @USER687 yeah . Looks like he is like Wakefield , in the US calling himself doctor when he has no right to the title .	PROPN PROPN INTJ PUNCT VERB SCONJ PRON AUX ADP NOUN PUNCT ADP DET PROPN VERB PRON NOUN ADV PRON VERB DET ADV ADP DET NOUN PUNCT
@USER931 it 's wild I promise you	VERB PRON AUX NOUN PRON VERB PRON
iOrange -E 10 ft Strongest Kevlar Fiber Lightning Cable and Retractable Lightning Cable from $ 9.99 AC @USER83 URL715	NOUN NOUN NUM VERB NOUN NOUN NOUN PROPN NOUN CCONJ NOUN NOUN NOUN ADP SYM X X X X
RT @USER338 : \ You 're all racists ! \ \ Actually , I just prefer democracy to a remote , self - serving ... \ \ Shut up ! Shut up ! Racist ! \ Etc.	X X PUNCT PUNCT PRON AUX DET NOUN PUNCT PUNCT PUNCT ADV PUNCT PRON ADV VERB NOUN ADP DET NOUN PUNCT NOUN PUNCT NOUN PUNCT PUNCT PUNCT VERB ADP PUNCT VERB ADP PUNCT NOUN PUNCT PUNCT X
RT @USER598 : Bryson Tiller had a 1 hell of a year	X X PUNCT NOUN NOUN VERB DET NUM NOUN ADP DET NOUN
RT @USER1766 : A fan account 's love of you is quantifiable by the amount of reblogged ugly pictures they think you look good in . #ThenkUA \u2026	X X PUNCT DET NOUN NOUN PART NOUN ADP PRON AUX NOUN ADP DET NOUN ADP NOUN ADJ NOUN PRON VERB PRON VERB ADJ ADP PUNCT X PUNCT
@USER1830 Now there 's a quote	NOUN ADV PRON AUX DET NOUN
Just take a normal pic of yourself and filter it black and white , that 's your gear , hahaha URL287	ADV VERB DET ADJ NOUN ADP PRON CCONJ VERB PRON ADJ CCONJ ADJ PUNCT PRON AUX PRON NOUN PUNCT X X
He fresh w the dad jeans \ud83d\udc80 URL541	PRON ADJ ADP DET NOUN X X X
RT @USER2485 : 2 BRAND NEW #Decay designs are available right now @ URL830 buy now for 20 % off URL464	X X PUNCT NUM NOUN ADJ NOUN NOUN AUX ADV ADV ADV ADP NOUN VERB ADV ADP NUM SYM ADP NOUN
best friend forever he said	ADJ NOUN ADV PRON VERB
Doncaster Phoenix too good for West Hartlepool - Hartlepool Mail #Doncaster URL1585	NOUN NOUN ADV ADJ ADP NOUN NOUN PUNCT X NOUN X X
RT @USER1313 : Here 's some motivation !! GO HARD GUYS #5SOSFam #BestFanArmy #iHeartAwards URL1466	X X PUNCT ADV AUX DET NOUN PUNCT VERB X NOUN X X X X
@USER709 @USER2377 NO THANKS NO MORE FOX ! ENJOY YOUR DEVOTED TIME TO THE MAN WHO WILL NOT GET THE FEMALE VOTE FOR PRESIDENT	PROPN VERB DET NOUN DET ADJ NOUN PUNCT X PRON NOUN NOUN ADP DET NOUN PRON AUX PART VERB DET NOUN VERB ADP NOUN
@USER229 If you are you interested in True Esoteric teachings , check URL954	NOUN SCONJ PRON AUX PRON VERB ADP NOUN NOUN X PUNCT VERB X
RT @USER2477 : Things that happened last Saturday & Sunday . Kath & DJ are nt lucky , they 're blessed . #VoteKathrynFPP #KCA URL708 \u2026	X X PUNCT NOUN PRON VERB ADJ NOUN CCONJ NOUN PUNCT X CCONJ PROPN AUX PART ADJ PUNCT PRON AUX ADJ PUNCT X X X PUNCT
I run yo brain around the block to jog your fuckin memory	PRON VERB PRON NOUN ADP DET NOUN PART VERB PRON NOUN NOUN
Curry finishes , passes , & averages 2+ steals a game ..... URL698	PROPN NOUN PUNCT NOUN PUNCT CCONJ NOUN NOUN VERB DET NOUN PUNCT X
RT @USER84 : Three years after @USER1663 died , I wrote a thing . About death and drugs and stigma . You can read it here . URL219 \u2026	X X PUNCT NUM NOUN ADP NOUN X PUNCT PRON VERB DET NOUN PUNCT ADP NOUN CCONJ NOUN CCONJ NOUN PUNCT PRON AUX VERB PRON ADV PUNCT X PUNCT
Girls all became annoying when they just wanted to \ Slayyy , yas bitch , mom \ud83d\ude0d , fabulous , FIERCE , omg slay my fucking life \ stfu lol	NOUN DET ADV ADJ ADV PRON ADV VERB ADP PUNCT NOUN PUNCT PROPN NOUN PUNCT NOUN SYM PUNCT NOUN PUNCT NOUN PUNCT INTJ VERB PRON ADJ NOUN PUNCT X INTJ
@USER2512 have shared the details . Expecting a call back from you .	NOUN AUX VERB DET NOUN PUNCT VERB DET NOUN ADV ADP PRON PUNCT
RT @USER2353 : Man I do n't feel like being at school	X X PUNCT NOUN PRON AUX PART VERB SCONJ AUX ADP NOUN
RT @USER2410 : 2/50 slightly behind Ashamed to say it 's taken me this long to find the time to sit and \u2026 URL552	X X PUNCT NOUN NOUN ADP NOUN PART VERB PRON AUX VERB PRON DET ADJ PART VERB DET NOUN PART VERB CCONJ PUNCT X
@USER1591 my bad lol	VERB PRON ADJ INTJ
MCGI : RT aiefrel : A million thanks to God for all the things that He has done to us ! To GOD be the Glory :) #MCGIEndlessThanksgiving	NOUN PUNCT X X PUNCT DET NUM NOUN ADP PROPN ADP DET DET NOUN SCONJ PRON VERB VERB ADP PRON PUNCT ADP NOUN AUX DET NOUN SYM X
RT @USER714 : Baby chimpanzee \ud83d\udc35 URL1478	X X PUNCT X X X X
I 'm ready to take the next step God .	PRON AUX ADJ PART VERB DET ADJ NOUN NOUN PUNCT
I 've finished the Bartolomeo 's Orders quest ! Are you able to fulfil the same task ? URL810 #android , #androidgames , #gam ...	PRON AUX VERB DET NOUN PART NOUN NOUN PUNCT AUX PRON VERB PART VERB DET ADJ NOUN PUNCT X X PUNCT PROPN PUNCT NOUN PUNCT
Reunited gon na win this #ThePlaysLaunch	NOUN VERB PART VERB DET NOUN
RT @USER1508 : Do you ever realize Sounds Live Feels Live Starts this month and just URL979	X X PUNCT AUX PRON ADV VERB ADJ ADJ NOUN PROPN VERB DET NOUN CCONJ ADV X
RT @USER561 : The safety of our kids is more important than the interests of the NRA . Our leaders should act like it . URL851 \u2026	X X PUNCT DET NOUN ADP PRON NOUN AUX ADJ ADJ ADP DET NOUN ADP DET NOUN PUNCT PRON NOUN AUX VERB ADP PRON PUNCT X PUNCT
RT @USER1871 : 160308 NATURE REPUBLIC FANSIGN IN BANGKOK Picture of u #SEHUN URL1573	X X PUNCT X X X X ADP NOUN NOUN ADP PRON NOUN X
RT @USER1538 : You bitches do the MOST for less \ud83d\ude02\ud83d\ude02\ud83d\ude02\ud83d\ude02\ud83d\ude34	X X PUNCT PRON NOUN VERB DET NOUN ADP ADJ NOUN
RT @USER2567 : 6 Things That You Did n't Know About The Fresh Prince Of Bel Air . >>> URL763 URL316	X X PUNCT NUM NOUN PRON PRON AUX PART VERB ADP DET ADJ PROPN ADP NOUN NOUN PUNCT X X X
@USER2659 ur album bout to be lit	PROPN PRON NOUN ADP PART AUX ADJ
RT @USER2428 : This is CARI pm me at URL1018 I will give u her phone number to meet in USA . U must be 18+ . URL223 \u2026	X X PUNCT PRON AUX NOUN NOUN PRON ADP PROPN PRON AUX VERB PRON PRON NOUN NOUN PART VERB ADP PROPN PUNCT PRON AUX AUX NOUN PUNCT X PUNCT
RT @USER2392 : Mysterious !!!	X X PUNCT NOUN PUNCT
RT @USER2278 : 95 % Discount on @USER1600 Secret Weapon #Trading Course & 6 Setups using #Ichimoku >> URL1373 ht \u2026	X X PUNCT NUM SYM NOUN ADP NOUN X X X X CCONJ NUM NOUN VERB NOUN PUNCT X X PUNCT
RT @USER1595 : follow everyone who retweets this URL1422	X X PUNCT VERB PRON PRON VERB PRON NOUN
Huawei P9 Release Date , Price and Specs - CNET : Huawei 's new P9 -- and its big brother , the P9 Plus -- have tw ... URL386	NOUN NOUN NOUN NOUN PUNCT NOUN CCONJ NOUN PUNCT NOUN PUNCT NOUN PART ADJ NOUN PUNCT CCONJ PRON ADJ NOUN PUNCT DET NOUN X PUNCT VERB X PUNCT X
Amazon 's already large distribution empire keeps expanding URL813 #storystream #sports	PROPN PART ADV NOUN X X VERB X X X X
@USER1758 thanks I appreciate it	PROPN NOUN PRON VERB PRON
. @USER1407 @USER2135 Sera Community #Rhino Sanctuary Celebrate first Eastern Black Rhino birth URL247 @USER1516	PUNCT X X X NOUN X X X ADV NOUN ADJ NOUN X X X
RT @USER2211 : Hillary Clinton dresses like she 's in charge of some sort of space federation . URL1205	X X PUNCT PROPN PROPN NOUN SCONJ PRON AUX ADP NOUN ADP DET NOUN ADP NOUN NOUN PUNCT X
@USER2623 you probly just deleted them all lmfao	PROPN PRON NOUN ADV ADV PRON DET INTJ
RT @USER845 : you know you made the wrong decision when marine le pen agrees URL1314	X X PUNCT PRON VERB PRON VERB DET ADJ NOUN ADV X X X X X
@USER1817 I love it ;)	PROPN PRON VERB PRON SYM
Stanley Cup Final Takeaways : Penguins top Sharks in thrilling Game 1 URL1393 penguinswinscf1.jpg \u2026 URL641	ADJ NOUN NOUN NOUN PUNCT NOUN NOUN NOUN ADP ADJ NOUN NUM NOUN X PUNCT X
2 people followed me // automatically checked by URL936	NUM NOUN VERB PRON SYM ADV VERB ADP NOUN
RT @USER1545 : This is gon na be my child URL1471	X X PUNCT PRON AUX VERB PART AUX PRON NOUN X
RT @USER1869 : Bulgaria 's president talks to euronews about free movement , migrants & border fences URL561 URL393 \u2026	X X PUNCT NOUN PART NOUN VERB PART NOUN ADP ADJ NOUN PUNCT NOUN CCONJ NOUN NOUN X X PUNCT
\ If I play dead , he 'll go away \	PUNCT SCONJ PRON VERB ADJ PUNCT PRON AUX VERB ADV PUNCT
@USER1188 Such a nice guy right ?	NOUN VERB DET ADJ NOUN ADV PUNCT
RT @USER122 : We \u2019re not dating , but you \u2019re still mine .	X X PUNCT PRON AUX PART VERB PUNCT CCONJ PRON AUX ADV PRON PUNCT
RT @USER744 : Kelsea performing in Chicago ! [ 2.4.16 ] ( @USER164 ) URL399	X X PUNCT NOUN NOUN ADP PROPN PUNCT PUNCT X PUNCT PUNCT NOUN PUNCT X
RT @USER2069 : Kangaroos hold off Bulldogs to maintain unbeaten start to AFL ... #EtihadStadium URL1093	X X PUNCT NOUN VERB ADP NOUN PART NOUN NOUN VERB ADP NOUN PUNCT X X
RT @USER1913 : when you find a boy that 's cute , texts back fast , buys you food , AND stays loyal af URL707	X X PUNCT ADV PRON VERB DET NOUN PRON AUX ADJ PUNCT VERB ADV ADJ PUNCT VERB PRON NOUN PUNCT CCONJ VERB X NOUN X
Black Wig Brasil : URL914	ADJ NOUN PROPN PUNCT X
More Photos As Mercy Aigbe Celebrates Her Son \u2019s 6th Birthday . URL1369 via @USER2638	ADJ NOUN ADV NOUN X X PRON NOUN PART ADJ NOUN PUNCT X ADP X
RT @USER1209 : Ppl will try to expose what 's wrong with u because they ca n't handle what 's right about u .	X X PUNCT VERB AUX VERB PART VERB PRON AUX ADJ ADP PRON SCONJ PRON AUX PART VERB PRON AUX ADV ADP PRON PUNCT
RT @USER1422 : \ So what does your Son do for a living ? \ URL1016	X X PUNCT PUNCT ADV PRON VERB PRON NOUN VERB ADP DET NOUN PUNCT PUNCT X
RT @USER1465 : Scientists now accept that we can bring dinosaurs back into the world using bird DNA .	X X PUNCT NOUN ADV VERB SCONJ PRON AUX VERB NOUN ADV ADP DET NOUN VERB NOUN NOUN PUNCT
RT @USER2551 : \ Excuse me , $ hillary , your baggage is over the limit . \ #NotMeUs #FBImWithHer @USER2222 @USER149	X X PUNCT PUNCT VERB PRON PUNCT SYM NOUN PUNCT PRON NOUN AUX ADP DET NOUN PUNCT PUNCT X X X X
Want to work at Kold Trans ? We 're #hiring in #Cheyenne , WY ! Click for details : URL1038 #trucker URL438	VERB PART VERB ADP PROPN NOUN PUNCT PRON AUX VERB ADP NOUN PUNCT NOUN PUNCT NOUN ADP NOUN PUNCT X X X
RT @USER1897 : park bom high note URL733	X X PUNCT NOUN NOUN ADJ NOUN X
RT @USER2133 : DrMSG @USER530 JI ALMIGHTY !! MSG #OneYearOfMSG	X X PUNCT X X PROPN NOUN PUNCT X X
goodnight twitter \ud83d\ude0e	NOUN VERB SYM
RT @USER1224 : MS : How New Treatment Combats The Disease URL1430	X X PUNCT X PUNCT ADV ADJ NOUN X DET NOUN X
RT @USER1835 : RT @USER45 A SciFi author explains why science fiction matters . \u25b6 URL1595 URL429 #amr \u2026	X X PUNCT X X DET NOUN X VERB ADV NOUN X NOUN PUNCT X X X X PUNCT
RT @USER1723 : Buy Brand Viagra 100 mg . Order Viagra at URL1618 Online Pharmacy !	X X PUNCT ADV ADJ PROPN NUM NOUN PUNCT NOUN PROPN ADP NOUN ADJ NOUN PUNCT
FOR A SECOND I WAS LIKE \ WHO 'S EMY \ BUT THEN IT HIT ME	ADP DET NOUN PRON AUX VERB PUNCT PRON AUX NOUN PUNCT CCONJ ADV PRON VERB PRON
to celebrate this remarkable day i will read a bunch of yaois thx	PART VERB DET NOUN NOUN PRON AUX VERB DET NOUN ADP NOUN X
RT @USER97 : Should I release this ? RT URL1497	X X PUNCT AUX PRON VERB PRON PUNCT X X
@USER1539 do n't say that about him \ud83d\ude29 he 's just young ..	NOUN AUX PART VERB PRON ADP PRON SYM PRON AUX ADV ADJ PUNCT
RT @USER1532 : Soccer is the best stress reliever .	X X PUNCT NOUN AUX DET ADJ NOUN NOUN PUNCT
RT @USER1432 : If you 're gon na see Deadpool a 3rd time , let me know when and where . Not asking for me . For my twin brother , Donald . h \u2026	X X PUNCT SCONJ PRON AUX VERB PART VERB VERB DET NOUN NOUN PUNCT VERB PRON VERB ADV CCONJ ADV PUNCT PART VERB ADP PRON PUNCT ADP PRON NOUN NOUN PUNCT PROPN PUNCT X PUNCT
@USER1547 We ca n't guarantee you 'll get a new one every time you reboot the router and ONT . It may take some time . ^DDD	PROPN PRON AUX PART VERB PRON AUX VERB DET ADJ NUM DET NOUN PRON VERB DET NOUN CCONJ NOUN PUNCT PRON AUX VERB DET NOUN PUNCT X
RT @USER2562 : Ca n't get enough of you baby	X X PUNCT AUX PART VERB ADJ ADP PRON NOUN
RT @USER2660 : I want to win @USER1865 's books giveaway ! #esthetichadidgiveaways P.S. Saved accounts are allowed ! \ud83d\udc97\ud83c\udf38\ud83c\udf3a URL885 \u2026	X X PUNCT PRON VERB PART VERB NOUN PART NOUN NOUN PUNCT X X X X AUX VERB PUNCT X X PUNCT
Man what a birthday	NOUN PRON DET NOUN
#movies The Best Summer Vacations in Movies : The Best Summer Vacations in Movies URL239 #celebs #celebrity	VERB DET ADJ NOUN NOUN ADP NOUN PUNCT DET ADJ NOUN NOUN ADP NOUN X X X
#roma : Salmo - The Italian Way URL578	NOUN PUNCT NOUN PUNCT DET PROPN NOUN X
RT @USER1414 : I 'm dead lmao \ud83d\ude2d\ud83d\ude02\ud83d\ude2d\ud83d\ude02\ud83d\ude02\ud83d\ude02\ud83d\ude02 \ @USER2557 : The woman you thought you married vs who you really married URL451 \	X X PUNCT PRON AUX ADJ INTJ NOUN PUNCT X PUNCT DET NOUN PRON VERB PRON VERB PROPN PRON PRON ADV ADJ NOUN PUNCT
HO MY GAWD URL1023	VERB PRON NOUN X
RT @USER360 : The statistics are staggering ... URL1534 #untj4270	X X PUNCT DET NOUN AUX NOUN PUNCT X X
I have cracked and opened up the bag of cool ranch doritos	PRON VERB NOUN CCONJ VERB ADP DET NOUN ADP ADJ X X
RT @USER1637 : You are my definition of the word \ love . \ Thank you .. thank you , @USER2199 . I am so proud of you .. always \u2764 URL895 \u2026	X X PUNCT PRON AUX PRON NOUN ADP DET NOUN PUNCT NOUN PUNCT PUNCT VERB PRON PUNCT VERB PRON PUNCT PROPN PUNCT PRON AUX ADV ADJ ADP PRON PUNCT ADV X X PUNCT
RT @USER2057 : I thought it was fake sub \ud83d\ude02\ud83d\ude02\ud83d\ude02\ud83d\ude02 URL648	X X PUNCT PRON VERB PRON AUX ADJ NOUN X X
RT @USER2578 : The fact that dogs respect ' no ' more than a lot of guys is really messed up .	X X PUNCT DET NOUN PRON NOUN NOUN PUNCT DET PUNCT ADJ ADP DET NOUN ADP NOUN AUX ADV VERB ADP PUNCT
RT @USER1131 : HEY ! NEW MUSIC VIDEO TOMORROW ! It 's to my song \ Home Sweet Home \ 3 pm EST / noon PST on URL307 URL223 \u2026	X X PUNCT INTJ PUNCT ADJ NOUN NOUN NOUN PUNCT PRON AUX ADP PRON NOUN PUNCT NOUN NOUN NOUN PUNCT NUM NOUN NOUN PUNCT NOUN X ADP NOUN X PUNCT
RT @USER934 : @USER2609 @USER1361 it 's very strange how they are bending over backwards to get rid of Jeremy Corbyn . He is a decent \u2026	X X PUNCT X VERB PRON AUX ADV NOUN ADV PRON AUX NOUN ADP NOUN PART VERB VERB ADP NOUN NOUN PUNCT PRON AUX DET NOUN PUNCT
RT @USER2368 : \ Studio Ohana \ is today 's tee on URL724 ReTweet for a chance at a FREE TEE ! URL394	X X PUNCT PUNCT PROPN NOUN PUNCT AUX NOUN PART NOUN ADP NOUN NOUN ADP DET NOUN ADP DET ADJ NOUN PUNCT X
@USER700 incredible show ! Thank you for the photo \ud83d\udc95 URL1076	PROPN ADJ NOUN PUNCT VERB PRON ADP DET NOUN X X
You and your family have questions about #retirement . This free guide provides answers : URL525 URL508	PRON CCONJ PRON NOUN VERB NOUN ADP NOUN PUNCT PRON ADJ NOUN X X PUNCT X X
Lawd knows I ai n't perfect but I sholl deserve it . Send somebody that wo n't turn they back on me .	PROPN VERB PRON AUX PART ADJ CCONJ PRON AUX VERB PRON PUNCT X PRON PRON AUX PART VERB PRON ADV ADP PRON PUNCT
@USER2355 Are you frustrated ?	NOUN AUX PRON NOUN PUNCT
RT @USER462 : My kind of waffles URL1433	X X PUNCT PRON NOUN ADP NOUN X
Told You I can fly \u2026 URL351	PROPN PRON PRON AUX VERB PUNCT X
Why was I so excited about my broken arm URL580	ADV AUX PRON ADV VERB ADP PRON ADJ NOUN X
RT @USER211 : FIRST LOOK : Virginia Madsen ( @USER2198 ) to guest star on #Elementary . Check - out via @USER392 : URL1356 URL222 \u2026	X X PUNCT ADJ NOUN PUNCT X NOUN PUNCT NOUN PUNCT ADP NOUN NOUN ADP NOUN PUNCT VERB PUNCT ADP ADP NOUN PUNCT X X PUNCT
@USER667 It can be very frustrating at times . That 's why I almost never fully open up to people .	PROPN PRON AUX AUX ADV ADJ ADP NOUN PUNCT PRON AUX ADV PRON ADV ADV VERB ADJ ADP ADP NOUN PUNCT
@USER2507 completely forgot about the NPA . We might have to renew our membership .	PROPN ADV VERB ADP DET NOUN PUNCT PRON AUX VERB PART VERB PRON NOUN PUNCT
RT @USER2506 : powerful @USER1061 piece by Tim Duncan . URL812	X X PUNCT ADJ NOUN NOUN ADP NOUN NOUN PUNCT X
@USER208 @USER665 @USER1253 you find that many people actually agree with voluntarism , once they 're questioned on it , unless	PROPN PROPN VERB PRON VERB PRON ADJ NOUN ADV VERB ADP NOUN PUNCT ADV PRON AUX VERB ADP PRON PUNCT SCONJ
RT @USER1081 : At it again ..... URL556	X X PUNCT ADV PRON ADV PUNCT X
RT @USER326 : . @USER863 owns this Big L painting . It 's \ The Big Picture \ cover . Instead of making a gun , L gives the thumbs up . URL0 \u2026	X X PUNCT PUNCT X VERB DET NOUN PROPN NOUN PUNCT PRON AUX PUNCT DET ADJ NOUN PUNCT NOUN PUNCT VERB ADP VERB DET NOUN PUNCT PROPN VERB DET NOUN ADP PUNCT X PUNCT
GD also worked with kush so why not iKON ? Ugly af \ud83d\udc80\ud83d\udc80\ud83d\udc80 URL470	NOUN ADV VERB ADP NOUN ADV ADV PART NOUN PUNCT ADJ NOUN X X
She Called 911 When Her 22 - Week - Old Baby Had Been Born Just One Day After An Abortion URL653	PRON VERB NOUN ADV PRON NOUN PUNCT NOUN PUNCT ADJ NOUN PRON AUX NOUN ADV NUM NOUN ADP DET NOUN X
RT @USER13 : OG 's aint chilling \ud83d\ude02 URL680	X X PUNCT X PART AUX NOUN SYM X
Microsoft Xbox 360 60 GB White Console w/ Controller and 512 mb Memory Card - Bid Now ! Only \u2026 URL884 URL1316	NOUN PROPN NOUN NUM NUM ADJ NOUN NOUN NOUN CCONJ NOUN NOUN NOUN NOUN PUNCT VERB ADV PUNCT ADV PUNCT X X
\u2018 A time bomb waiting to explode \u2019 \u2013 Survey reveals GPs \u2019 concerns about mental health services for young people #teens #health	PUNCT DET NOUN NOUN VERB ADP NOUN PUNCT PUNCT PROPN NOUN X PUNCT NOUN ADP NOUN NOUN NOUN ADP ADJ NOUN X X
RT @USER422 : What the ...... URL761	X X PUNCT PRON DET NOUN X
RT @USER33 : 5000 #TheNextGalaxy retweets in 30 mins unlock the box ! RT & you stand a chance to WIN R30000 with @USER1173 URL1564 \u2026	X X PUNCT NOUN NOUN NOUN ADP NUM NOUN VERB DET NOUN PUNCT VERB CCONJ PRON VERB DET NOUN PART VERB NOUN ADP NOUN X PUNCT
Let 's take a cruise \ud83c\udf00 URL243	VERB PART VERB DET NOUN X X
RT @USER2415 : Asaram BapuJi - ' Parenthood is beyond castes & religions . Respect ur parents ! ' #LovedParentsWorshipDay URL777	X X PUNCT NOUN NOUN PUNCT PUNCT NOUN AUX ADP NOUN CCONJ NOUN PUNCT NOUN PRON NOUN PUNCT PUNCT X X
#NowPlaying Shawn Mendes Camila Cabello - I Know What You Did Last Summer :: Tune In : URL780	X PROPN PROPN PROPN NOUN PUNCT PRON VERB PRON PRON VERB NOUN NOUN NOUN NOUN ADP PUNCT X
@USER253 Oxygen ...... I need oxygen . I 'm laughing so hard on forgot to breath \ud83d\ude02\ud83d\ude02\ud83d\ude02\ud83d\ude02\ud83d\ude02\ud83d\ude02\ud83d\ude02\ud83d\ude02\ud83d\ude02\ud83d\ude02\ud83d\ude02\ud83d\ude02\ud83d\ude02\ud83d\ude02\ud83d\ude02\ud83d\ude02\ud83d\ude02\ud83d\ude02\ud83d\ude02\ud83d\ude02\ud83d\ude02\ud83d\ude02\ud83d\ude02\ud83d\ude02\ud83d\ude02\ud83d\ude02\ud83d\ude02\ud83d\ude02\ud83d\ude02\ud83d\ude02\ud83d\ude02\ud83d\ude02\ud83d\ude02\ud83d\ude02\ud83d\ude02\ud83d\ude02\ud83d\ude02\ud83d\ude02\ud83d\ude02\ud83d\ude02	PROPN PROPN PROPN PRON VERB NOUN PUNCT PRON AUX VERB ADV ADJ ADP VERB ADP VERB X
RT @USER749 : This is the # 1 tip sheet for dealing with stress : URL1204 URL806	X X PUNCT PRON AUX DET NOUN NUM NOUN NOUN ADP NOUN ADP NOUN PUNCT X X
Yes RT @USER2261 : Honest opinion do I come off as a nigga with multiple women ?	INTJ X X PUNCT X NOUN AUX PRON VERB ADP ADP DET NOUN ADP ADJ NOUN PUNCT
@USER730 @USER1279 @USER2031 want to dota ?	NOUN NOUN NOUN VERB PART NOUN PUNCT
RT @USER630 : The first picture is Chicago at 2:30 on April 2 , 2016 The second picture is Chicago at 2:40 April 2 , 2016 \ud83c\udf1e\ud83c\udf1a URL223 \u2026	X X PUNCT DET ADJ NOUN AUX PROPN ADP NOUN ADP PROPN NUM PUNCT NUM DET ADJ NOUN AUX PROPN ADP PROPN PROPN NUM PUNCT NUM X X PUNCT
RT @USER284 : I imagine feminists are gon na be insufferable about it .	X X PUNCT PRON VERB NOUN AUX VERB PART AUX VERB ADP PRON PUNCT
RT @USER1625 : 13 . \ why do n't i have a penis \ I CANTRS BREATHE URL570	X X PUNCT NUM PUNCT PUNCT ADV AUX PART PRON VERB DET NOUN PUNCT PRON VERB X X
Lmao these dudes are at mcgolf URL1280	INTJ DET NOUN AUX ADP NOUN X
6 reasons you need to buy auto insurance URL671	NUM NOUN PRON VERB PART VERB NOUN X X
RT @USER1384 : Groupme emojis way more lit than the regular iOS emojis \ud83d\ude1e	X X PUNCT NOUN VERB ADV ADV ADJ ADP DET NOUN PROPN X X
RT @USER1839 : I need to fall In Love with a New Rap song . It s been long	X X PUNCT PRON VERB PART VERB ADP NOUN ADP DET ADJ NOUN NOUN PUNCT PRON AUX AUX ADJ
Arab & Iranian Leaders Who Are Mostly Muslims & Read The Quran MUST Become Role Models For Promoting The Unity of The Human Family .	NOUN CCONJ NOUN NOUN PRON AUX ADJ NOUN CCONJ VERB DET NOUN AUX NOUN NOUN X ADP NOUN DET NOUN ADP DET ADJ NOUN PUNCT
Wan na have a deep conversation	VERB PART VERB DET ADJ NOUN
@USER316 @USER1030 the UK that existed then does n't exist now . Next !	NOUN VERB DET PROPN PRON NOUN ADV AUX PART ADV ADV PUNCT ADJ PUNCT
RT @USER1616 : electric forest \ud83c\udf32	X X PUNCT X X X
@USER1505 loved it ... thank you so much	PROPN VERB PRON PUNCT VERB PRON ADV ADV
Found a Transponder Snail ! Giants , sea monsters and other amazing encounters ! URL1483 #TreCru URL259	VERB DET NOUN NOUN PUNCT NOUN PUNCT NOUN NOUN CCONJ ADJ ADJ NOUN PUNCT X X X
Another day to be productive \ud83d\udcaa\ud83c\udffe #LetsGetIt \ud83d\udc4a\ud83c\udffe	DET NOUN PART AUX ADJ X X X
@USER2014 of @USER1220 a HAPPY 28th BIRTHDAY ! #NBABDAY URL909	NOUN ADP NOUN DET ADJ NOUN NOUN PUNCT X X
@USER1712 @USER1362 I 'm already dead	PROPN PROPN PRON AUX ADV ADJ
When you 're happy , you enjoy the music and when you 're sad , you understand the lyrics . #markisanation	ADV PRON AUX ADJ PUNCT PRON VERB DET NOUN CCONJ ADV PRON AUX ADJ PUNCT PRON VERB DET NOUN PUNCT X
RT @USER1627 : I 'm tryna get in a healthy relationship , shit \ud83d\ude02\ud83d\ude02 URL231	X X PUNCT PRON AUX VERB VERB ADP DET ADJ NOUN PUNCT NOUN SYM X
Hello @USER174 , thank you for partnering with us . We are always delighted to serve you . Do have a great day .	INTJ NOUN PUNCT VERB PRON ADP NOUN ADP PRON PUNCT PRON AUX ADV NOUN PART VERB PRON PUNCT AUX VERB DET ADJ NOUN PUNCT
Cant wait . \ud83d\ude48\ud83d\udc83 Temme your gang is winning right ? \ud83d\ude25 Haina ? \ud83d\ude0b URL631	NOUN VERB PUNCT X VERB PRON NOUN AUX VERB ADV PUNCT PROPN X PUNCT VERB X
#CinObservatory #OHWX : Temp : -0.28 \u00b0C , Hum : 68 % , Bar : mb , UV : 1/1600 , As of : April 10 , 2016 at 12:04 AM	ADJ NOUN PUNCT NOUN PUNCT NOUN NOUN PUNCT NOUN PUNCT NOUN SYM PUNCT NOUN PUNCT NOUN PUNCT X PUNCT NOUN PUNCT ADV ADP PUNCT PROPN NUM PUNCT NUM ADP PROPN NOUN
@USER1605 Bracelet in right hand is missing Piercing on chin is missing #SpotTheMissing .	NOUN NOUN ADP ADJ NOUN AUX NOUN NOUN ADP NOUN AUX NOUN NOUN PUNCT
Fuck today . Fuck Imogen . Fuck all of it !	VERB NOUN PUNCT INTJ NOUN PUNCT VERB DET ADP PRON PUNCT
RT @USER522 : \u201c It \u2019s a red flag \u201d \u2014 Polar bears are losing weight as #Arctic sea ice melts . URL526 #SaveTheArctic URL221 \u2026	X X PUNCT PUNCT PRON VERB DET ADJ NOUN PUNCT PUNCT X NOUN AUX VERB NOUN ADP NOUN NOUN NOUN NOUN PUNCT X X X PUNCT
@USER1003 ok lol also I have never been awake at 5 in years lol earliest I get up at is 8 in the morning lol	PROPN INTJ INTJ ADV PRON VERB ADV AUX NOUN ADP NUM ADP NOUN INTJ X PRON VERB ADP ADP AUX NUM ADP DET NOUN INTJ
[ OnlyPiolou ] is available since 2 minute ( s ) ! ( 2016-03-19 11:38:49 ) ( UTC+01:00 ) - #minecraft	PUNCT NOUN PUNCT AUX ADJ ADV NUM NOUN PUNCT NOUN PUNCT PUNCT PUNCT NOUN NOUN PUNCT PUNCT NOUN PUNCT PUNCT X
RT @USER1337 : Classic \ud83d\ude01 URL1443	X X PUNCT ADJ NOUN X
RT @USER648 : @USER2067 @USER790 @USER661 @USER1148 @USER1751 means ya get to start drinking whenever ya want	X X PUNCT X X X X X VERB PRON VERB PART VERB NOUN ADV PRON VERB
Votes from thepeoplepick what person isthe next sittingpresident . \ WHO PICKS \ THEPEOPLE THAT WILLBETHE PERSONS WE VOTE FOR2BE NEXT PRESIDENT . ?	NOUN ADP VERB PRON NOUN NOUN ADJ NOUN PUNCT PUNCT PRON NOUN PUNCT X PRON NOUN X PRON VERB NOUN X NOUN PUNCT PUNCT
SOON : We reveal the secret signals your body 's giving off without you even knowing ... #TMS7	NOUN PUNCT PRON VERB DET NOUN VERB PRON NOUN PART VERB ADP ADP PRON ADV PRON PUNCT X
Just posted a photo @ La Provence Lake Oswego URL237	ADV VERB DET NOUN ADP X X X X X
Why the Stakes Are So High in Today \u2019s Rivers Election URL1634	ADV DET NOUN AUX ADV NOUN ADP NOUN PART NOUN X X
RT @USER838 : I want to be with you . Everyday .	X X PUNCT PRON VERB PART AUX ADP PRON PUNCT NOUN PUNCT
RT @USER129 : I , a large wrinkle , have made these smaller wrinkles . URL1067	X X PUNCT PRON PUNCT DET NOUN NOUN PUNCT VERB VERB DET NOUN NOUN PUNCT X
You prefer to keep the peace but you might feel called to spea ... More for Libra URL1015	PRON VERB PART VERB DET NOUN CCONJ PRON AUX VERB VERB PART NOUN PUNCT ADJ ADP NOUN X
HAHAHAHAH OMG KHLOE IF YOU WANT TO DRAG SOMEONE PLEASE DONT END UP BEING EMBARRASSING	PROPN INTJ NOUN SCONJ PRON VERB PART NOUN NOUN INTJ VERB PUNCT ADP NOUN X
RT @USER28 : On October 7 \u2022 Fifth Harmony will perform at the Manchester Arena Capacity : 21,000 People #727Tour URL736	X X PUNCT ADP PROPN NUM NOUN PROPN PROPN AUX VERB ADP DET PROPN NOUN X PUNCT X NOUN X X
Till I loved , I never lived -- enough . - Emily Dickinson	PROPN PRON VERB PUNCT PRON ADV NOUN PUNCT ADV PUNCT PUNCT X X
@USER879 last time I checked . July 22nd is in fact in summer ???	NOUN ADJ NOUN PRON VERB PUNCT PROPN NOUN AUX ADP NOUN ADP NOUN PUNCT
RT @USER1552 : This Man 's Blackheads Were Popped Out , See The Shocking Transformation After URL1248 URL492 \u2026	X X PUNCT DET NOUN PART NOUN NOUN X ADV PUNCT VERB DET NOUN NOUN ADP NOUN X PUNCT
ayerene - @USER1654 - babe - zayn -spongeboobs - pretty af - ia bc school ily \ud83d\ude3d	NOUN PUNCT NOUN PUNCT NOUN PUNCT X NOUN PUNCT ADV NOUN PUNCT X SCONJ NOUN NOUN X
RT @USER1621 : As Assad destroys much of health system , Syrians die as often of chronic disease as bullets . URL1082 htt \u2026	X X PUNCT ADV NOUN NOUN ADV ADP NOUN NOUN PUNCT NOUN VERB ADP ADV ADP NOUN NOUN ADP NOUN PUNCT X X PUNCT
@USER198 thanks for getting back to me so quickly .	PROPN NOUN SCONJ VERB ADV ADP PRON ADV ADV PUNCT
Morning lovelies \u2728 hope you have a wonderful day \ud83d\udc90 xxx URL1462	NOUN PROPN NOUN VERB PRON VERB DET ADJ NOUN X SYM X
RT @USER1996 : Team B - Climax 140413 , YG Family Power 2014 Tour in Japan Junhoe singing with a pistachio stuck in his throat ! \ud83d\ude31\ud83d\ude09 URL218 \u2026	X X PUNCT NOUN X PUNCT NOUN NOUN PUNCT NOUN NOUN NOUN NUM NOUN ADP PROPN NOUN VERB ADP DET NOUN VERB ADP PRON NOUN PUNCT X X PUNCT
RT @USER2560 : #EURO2016 Group F FT #POR 0-0 #AUT URL792	X X PUNCT PROPN X X PROPN X X X X
RT @USER1752 : hair color by your 's truly URL364	X X PUNCT NOUN NOUN ADP PRON AUX ADV X
@USER111 #Prophecy of #StrictlyBidness on #ReverbNation #HitPlay URL1132	NOUN NOUN ADP NOUN ADP NOUN X X
Turkey 's Erdogan pours cold water on hopes of progress on EU deal URL571 via @USER1123	PROPN PART NOUN NOUN ADJ NOUN ADP NOUN ADP NOUN ADP PROPN NOUN NOUN ADP X
RT @USER2000 : Mother - daughter relationship like Atita Haris & her daughter please ! \ud83d\ude0d\ud83d\ude0d\ud83d\ude0d URL1053	X X PUNCT NOUN PUNCT NOUN NOUN ADP NOUN NOUN CCONJ PRON NOUN INTJ PUNCT X X
RT @USER2320 : * opens Snapchat * \ so today I was .... \ \ I just hate when .. \ \ lem me tell y'all what just happe .... \ \ my boyfriend .. \ URL218 \u2026	X X PUNCT PUNCT NOUN PROPN PUNCT PUNCT ADV NOUN PRON AUX PUNCT PUNCT PUNCT PRON ADV VERB ADV PUNCT PUNCT PUNCT VERB PRON VERB VERB PRON ADV NOUN PUNCT PUNCT PUNCT PRON NOUN PUNCT PUNCT X PUNCT
#PromoProduct Need Something For the Office ? Choose Branded Merchandise As Corporate Gifts URL1126	NOUN VERB NOUN ADP DET NOUN PUNCT VERB NOUN X ADV X X X
LIMITED EDITION half nudes	NOUN NOUN ADP NOUN
@USER858 block 2C	NOUN NOUN X
LloydsPharmacy : Pharmacist - Attleborough #Pharmacy URL1162	NOUN PUNCT NOUN PUNCT X X X
Whatever song @USER1393 just made me listen to by ariana grande completely snatched me I 'm changed	PROPN NOUN NOUN ADV VERB PRON VERB ADP ADP PROPN NOUN ADV VERB PRON PRON AUX VERB
RT @USER22 : RT & REPLY ! #iHeartAwards #BestFanArmy #5SOSFam URL261	X X PUNCT VERB CCONJ INTJ PUNCT X X X X
Sooooo good to find the London #culinary scene is still as #awesome as ever thank you @USER818 #raresteak URL952	NOUN ADJ PART VERB DET PROPN NOUN NOUN AUX ADV ADP NOUN SCONJ ADV VERB PRON X X X
Helping You Get A Better Understanding About Employment With Simple Tips URL1051	VERB PRON VERB DET ADJ NOUN ADP NOUN ADP NOUN NOUN X
#porn #porn Swipe Hookup - meet sexy ladies for SEX DATING - visit : URL553 URL697	X X X X PUNCT VERB ADJ NOUN ADP NOUN NOUN PUNCT X PUNCT X X
Want to bang me ? URL1254 #ass #butt #orgies #sexygifs URL245	VERB PART VERB PRON PUNCT X X X X X X
best thing ever is definitely when people read your message and do n't reply	ADJ NOUN ADV AUX ADV ADV NOUN VERB PRON NOUN CCONJ AUX PART VERB
\ud83d\udc4c\ud83d\udc83 ( with family at Mie Alfin Pengayoman ) \u2014 URL1300	NOUN PUNCT ADP NOUN ADP PROPN X X PUNCT PUNCT X
RT @USER990 : @USER1815 and yet u chose to make the unarmed victim look like a criminal in this case .. \ud83e\udd14	X X PUNCT NOUN CCONJ ADV PRON NOUN PART VERB DET NOUN NOUN VERB ADP DET NOUN ADP DET NOUN PUNCT SYM
I stay getting mad at old shit I need to stop \ud83d\ude2d	PRON VERB VERB ADJ ADP ADJ NOUN PRON VERB PART VERB SYM
RT @USER2007 : Your heart beats about 100,00 times in one day and 36.5 million times in a year .	X X PUNCT PRON NOUN NOUN ADP NOUN NOUN ADP NUM NOUN CCONJ NOUN NUM NOUN ADP DET NOUN PUNCT
RT @USER311 : Lovable AND Quick Do it yourself VALENTINE 'S Working day Presents | THE SORRY Girls - URL1459	X X PUNCT NOUN CCONJ ADJ AUX PRON PRON NOUN PART VERB NOUN NOUN SYM DET ADJ NOUN PUNCT X
well it s a dream job for many , some in the testing section haha URL694	CCONJ PRON AUX DET NOUN NOUN ADP ADJ PUNCT DET ADP DET NOUN NOUN INTJ X
I hate not getting my way and I hate being told no but I m never told no and I always get my way so I have no complaints \ud83d\ude02	PRON VERB PART VERB PRON NOUN CCONJ PRON VERB AUX VERB DET CCONJ PRON AUX ADV VERB DET CCONJ PRON ADV VERB PRON NOUN ADV PRON VERB DET NOUN SYM
RT @USER1515 : I needa stop sleeping thru like half the day BC I always end up being up all night \ud83d\ude43	X X PUNCT PRON VERB VERB VERB NOUN ADP VERB DET NOUN SCONJ PRON ADV VERB ADP AUX ADP DET NOUN SYM
RT @USER2023 : try this class out let me know what you think URL1547	X X PUNCT VERB PRON NOUN ADP VERB PRON VERB PRON PRON VERB X
RT @USER1520 : Mitch to Raul - I think Nikki ca nt win but Tim can . I think he says he does nt want to win but he does #BBCAN4	X X PUNCT NOUN ADP PROPN PUNCT PRON VERB NOUN AUX PART VERB CCONJ NOUN AUX PUNCT PRON VERB PRON VERB PRON AUX PART VERB PART VERB CCONJ PRON AUX VERB
RT @USER327 : Type of girl I want \ud83d\ude4c\ud83c\udffc URL365	X X PUNCT NOUN ADP NOUN PRON VERB X X
Pain is just a consequence of love	NOUN AUX ADV DET NOUN ADP NOUN
@USER2500 w me in background	NOUN ADP PRON ADP NOUN
@USER1040 cool dude you are \ud83d\ude0e	PROPN ADJ NOUN PRON AUX SYM
RT @USER1864 : Beautiful California Flower Fields You Must Visit This Spring \u25ba URL337 @USER1336 #SanDiego URL218 \u2026	X X PUNCT ADJ PROPN NOUN X PRON AUX VERB DET NOUN X X X X X PUNCT
How to fill baseball 's biggest roster holes : Dozens of free agents remain unsigned , including many household n ... URL1602	ADV PART NOUN NOUN PART ADJ NOUN NOUN PUNCT NOUN ADP ADJ NOUN NOUN NOUN PUNCT VERB ADJ NOUN CCONJ PUNCT X
RT @USER1811 : iTunes US : 64 ( + 2 ) Demi Lovato - Body Say ! Buy or gift here : URL1593	X X PUNCT ADV NOUN PUNCT NOUN PUNCT SYM NUM PUNCT PROPN NOUN PUNCT NOUN VERB PUNCT VERB CCONJ NOUN ADV PUNCT X
Donald Trump Reads The Snake Lyric At Campaign Rally Referring To Immigr ... URL295 via @USER1490	PROPN PROPN VERB DET NOUN NOUN ADP NOUN NOUN NOUN PART NOUN PUNCT X ADP PROPN
RT @USER1980 : Curse on Such TABDEELi And New Pakistan in which Women being Molested , Harassed by their own Hooligans !!! #PTIwomenMolesters	X X PUNCT NOUN ADP ADJ NOUN CCONJ ADJ NOUN ADP DET NOUN AUX NOUN PUNCT VERB ADP PRON ADJ NOUN PUNCT X
RT @USER2312 : Maybe If I Was Harry Styles I Could Swim Across The Atlantic .	X X PUNCT VERB SCONJ PRON AUX PROPN NOUN PRON AUX NOUN NOUN DET NOUN PUNCT
LIVE on #Periscope : YoungBankRoll URL1563	PROPN ADP PROPN PUNCT X X
RT @USER1764 : they just Used winwin	X X PUNCT PRON ADV SYM NOUN
RT @USER2213 : WMUR reporting that Cruz will announce intention to name Fiorina running mate .	X X PUNCT NOUN X PRON PROPN AUX VERB NOUN ADP PROPN NOUN VERB NOUN PUNCT
RT @USER1347 : 10 Thousand Times Faster Swift URL1075	X X PUNCT NUM NUM NOUN NOUN PROPN X
Peter Capaldi Confirms New Doctor Who Companion Has Been Cast : Current Doctor Who Peter Capaldi \u2026 URL857 #drwho #doctorwho	NOUN NOUN NOUN ADJ NOUN PRON NOUN AUX AUX NOUN PUNCT X X PRON X X PUNCT X X X
You can get carried away with your desire to retreat from the ... More for Aries URL531	PRON AUX VERB VERB ADV ADP PRON NOUN PART NOUN ADP DET PUNCT ADJ ADP NOUN X
@USER1431 btw , are you Hispanic ? I 've been meaning to ask !	PROPN INTJ PUNCT AUX PRON NOUN PUNCT PRON AUX AUX VERB PART VERB PUNCT
RT @USER2631 : Wrong number texted me today URL374	X X PUNCT ADJ NOUN NOUN PRON NOUN X
RT @USER382 : Ted Cruz promised people of Texas he 'd lead fight against Obamacare , exploding debt , cronyism & amnesty . Ted Cruz promised , t \u2026	X X PUNCT PROPN PROPN NOUN NOUN ADP PROPN PRON AUX VERB VERB ADP PROPN PUNCT PROPN NOUN PUNCT NOUN CCONJ NOUN PUNCT PROPN PROPN NOUN PUNCT X PUNCT
New goal : become an Olympic pup ! URL1019	ADJ NOUN PUNCT VERB DET NOUN NOUN PUNCT X
RT @USER740 : Donovan Mitchell 's athletic ability is unreal .	X X PUNCT X PROPN PART NOUN NOUN AUX NOUN PUNCT
RT @USER2297 : The only straight I am is a straight up bitch	X X PUNCT DET ADV ADV PRON AUX AUX DET ADJ ADP NOUN
I miss him \ud83d\ude14\ud83d\udc99	PRON VERB PRON NOUN
RT @USER504 : Tfry wild af \ud83d\ude02	X X PUNCT X X NOUN SYM
RT @USER1418 : Yeah getting buckets is important but so is stopping someone from getting them is too . URL722	X X PUNCT INTJ VERB NOUN AUX ADJ CCONJ ADV AUX VERB PRON ADP VERB PRON AUX ADV PUNCT X
RT @USER800 : Gone Viral ! This Mum & 1 Day Old Baby Sea Otter Cuddling Are A Cuteness Overload ! - CLICK --> >>> URL447 URL218 \u2026	X X PUNCT ADV NOUN PUNCT DET NOUN CCONJ NUM NOUN ADJ NOUN X X X AUX DET NOUN NOUN PUNCT PUNCT ADV SYM X X X PUNCT
@USER54 thanks for sharing ---==AdamCSmith==--- , have a great Friday :) ( Want this FREE ? >> URL391 )	PROPN NOUN ADP NOUN NOUN PUNCT VERB DET ADJ NOUN SYM PUNCT VERB PRON ADJ PUNCT PUNCT X PUNCT
RT @USER631 : Most slept on artists of today 23 . ) Joey Purp URL1159	X X PUNCT ADJ NOUN ADP NOUN ADP NOUN NUM PUNCT PUNCT X X X
RT @USER95 : Dear Leaders of the Opposition ! Do nt let Your dislike for PM @USER2286 translate into your support for people who want \u2026	X X PUNCT NOUN NOUN ADP DET NOUN PUNCT AUX PART VERB PRON NOUN ADP NOUN PROPN NOUN ADP PRON NOUN ADP NOUN PRON VERB PUNCT
How TO Get Over Your Ex Fast - URL1395 URL1513	ADV PART VERB ADP PRON PROPN NOUN PUNCT X X
Dierks Bentley Is Having Naked Nightmares About Hosting the ACM Awards - and Everyone Benefits ! URL618	NOUN NOUN AUX ADV NOUN NOUN ADP PROPN DET NOUN NOUN PUNCT CCONJ ADV NOUN PUNCT X
Mad men is got to be the best show of all time . Up there with the greats ( i.e. Sopranos ) if not the ultimate best .	NOUN NOUN AUX VERB PART AUX DET ADJ NOUN ADP DET NOUN PUNCT ADP ADV ADP DET NOUN PUNCT NOUN NOUN PUNCT SCONJ PART DET ADJ ADJ PUNCT
Hot Video ! ' In bed with Kanye ' : Sophie Monk parodies rapper 's ... URL428	ADJ NOUN PUNCT PUNCT ADP NOUN ADP PROPN PUNCT PUNCT X X X NOUN PART PUNCT X
Planning a heist at Game to get a copy of No Man 's Sky instead of waiting a week . I know they have it .	VERB DET NOUN ADP NOUN PART VERB DET NOUN ADP DET NOUN PART NOUN ADV ADP VERB DET NOUN PUNCT PRON VERB PRON VERB PRON PUNCT
Hello from the other side I must 've called a thousand times @USER2316	INTJ ADP DET ADJ NOUN PRON AUX AUX VERB DET NUM NOUN X
RT @USER988 : VIDEO : The @USER584 staged a live sit - in to address gun control measures and gun violence URL869 #NoB \u2026	X X PUNCT NOUN PUNCT DET NOUN NOUN DET ADJ VERB PUNCT ADP ADP NOUN NOUN NOUN NOUN CCONJ NOUN NOUN X X PUNCT
am i the only one that does n\u2019t do anything the whole day but gets depressed when the day ends and sees they did n\u2019t do anything	AUX PRON DET ADJ NUM PRON AUX PART VERB PRON DET ADJ NOUN CCONJ VERB NOUN ADV DET NOUN NOUN CCONJ NOUN PRON AUX PART VERB PRON
A new territory is discovered in The Tribez & Castlez ! Can you unlock it too ? URL965 #android , #androidgames , #gameinsight	DET ADJ NOUN AUX NOUN ADP DET NOUN CCONJ NOUN PUNCT AUX PRON VERB PRON ADV PUNCT X X PUNCT X PUNCT X
@USER2328 I love you in the purest sense	PROPN PRON VERB PRON ADP DET NOUN NOUN
@USER457 A1 ) 1 . Ninja Turtles 2 . Iron Man 3 . Captain America 4 . Patrick 5 . Darth Vader 6 . Spongebob #FlipkartCuriousCases	NOUN NUM PUNCT NUM PUNCT NOUN NOUN NUM PUNCT NOUN NOUN NUM PUNCT PROPN PROPN NUM PUNCT NOUN NUM PUNCT X X NUM PUNCT X X
RT @USER1901 : fucking endless women you do n't care about is n't gon na change the fact that you still love your ex girlfriend my nigga . \u2026	X X PUNCT ADJ NOUN NOUN PRON AUX PART VERB ADP AUX PART VERB PART VERB DET NOUN SCONJ PRON ADV VERB PRON NOUN VERB PRON NOUN PUNCT PUNCT
181 Death and All His Friends #VeranoMTV2016 Coldplay #MTVHottest Coldplay	NOUN NOUN CCONJ DET PRON NOUN SYM PROPN X PROPN
* Tips To Get A Girlfriend Without Spending Too Much Money >> URL557	PUNCT NOUN PART VERB DET NOUN ADP NOUN ADV ADJ NOUN PUNCT X
RT @USER298 : Highest quality tea tree oil on the market . #beauty #health #skincare #teatreeoil URL158 URL137 \u2026	X X PUNCT NOUN NOUN NOUN NOUN NOUN ADP DET NOUN PUNCT X X X X X X PUNCT
Hey , @USER2366 , let 's go on a #DateNight to see @USER1892 . \ud83d\udc91\ud83d\ude02 . I see lots of belly laughs in our future !!! \ud83d\udd2e URL1434	INTJ PUNCT NOUN PUNCT VERB PART VERB ADP DET NOUN PART VERB NOUN PUNCT X PUNCT PRON VERB NOUN ADP NOUN NOUN ADP PRON NOUN PUNCT X X
RT @USER1293 : Glaswegian burds say there 's nuhin sexier than the sound ae a boy rippin aff his velcro trainers	X X PUNCT X X VERB PRON AUX NOUN NOUN ADP DET NOUN NOUN DET NOUN NOUN X PRON NOUN X
Haters gon na hate	NOUN VERB PART VERB
@USER1645 you 've changed a lot jkjk	PROPN PRON AUX VERB DET NOUN NOUN
RT @USER2191 : This Rare Picture Captures Something That Happens In Less Than 1 Out Of 80,000 Births URL1010	X X PUNCT DET NOUN NOUN NOUN X PRON NOUN ADP NOUN ADV NUM ADP ADP NOUN X X
RT @USER1204 : Today is a big day if you are hoping to become a wealthy venture capitalist URL1505 h/t @USER621 URL220 \u2026	X X PUNCT NOUN AUX DET ADJ NOUN SCONJ PRON AUX VERB PART VERB DET NOUN X X X X X X PUNCT
RT @USER918 : It 's still \ud83c\udf40\ud83c\udf40\ud83c\udf40\ud83c\udf40\ud83c\udf40 all day	X X PUNCT PRON AUX ADV VERB DET NOUN
@USER112 please follow me !!	PROPN INTJ VERB PRON PUNCT
RT @USER2423 : every time a white person meets a Muslim at a grocery store they write a dramatic Facebook post about it lol URL1633 \u2026	X X PUNCT DET NOUN DET ADJ NOUN NOUN DET NOUN ADP DET NOUN NOUN PRON VERB DET ADJ PROPN NOUN ADP PRON INTJ X PUNCT
RT @USER2292 : \ud83d\ude02\ud83d\ude02\ud83d\ude02\ud83d\ude02\ud83d\ude02 ladies are enjoying this #SAMenBreakTheInternet	X X PUNCT PROPN NOUN AUX VERB PRON NOUN
Here just swingin URL987	ADV ADV NOUN X
RT @USER2531 : 10 . When Rihanna was getting LIT to her own song while getting a manicure , she was really feeling herself . \ud83d\ude0d\ud83d\ude1c URL224 \u2026	X X PUNCT NUM PUNCT ADV PROPN AUX VERB PROPN ADP PRON ADJ NOUN SCONJ VERB DET NOUN PUNCT PRON AUX ADV VERB PRON PUNCT X X PUNCT
Thanks @USER2372 for the follow ! I really appreciate it ! Looking forward to learning more about you and what you do :-)	NOUN NOUN ADP DET NOUN PUNCT PRON ADV VERB PRON PUNCT VERB ADV PART NOUN ADJ ADP PRON CCONJ PRON PRON VERB SYM
hell naw ... maybe after spring break URL346	NOUN INTJ PUNCT ADV ADP NOUN X X
Looking for a new epilator ? Philips Satin Soft Wet & Dry Epilator now \u00a3 30 ( WAS \u00a3 100 ) from our OFFICIAL @USER1845 shop URL941	VERB ADP DET ADJ NOUN PUNCT X X X X CCONJ NOUN NOUN ADV SYM NUM PUNCT AUX SYM NUM PUNCT ADP PRON NOUN X X X
These guys are just so full of themselves , saying such things . \ Great gesture and confidence booster \ , apparently . URL384	DET NOUN AUX ADV ADV ADJ ADP PRON PUNCT VERB DET NOUN PUNCT PUNCT ADJ NOUN CCONJ NOUN NOUN PUNCT PUNCT NOUN PUNCT X
RT @USER627 : I 'm the most jealous person on the planet . what 's mine is mine , do n't look at it , do n't touch , and do n't even think ab \u2026	X X PUNCT PRON AUX DET ADJ ADJ NOUN ADP DET NOUN PUNCT PRON AUX PRON AUX PRON PUNCT AUX PART VERB ADP PRON PUNCT AUX PART VERB PUNCT CCONJ AUX PART ADV VERB NOUN PUNCT
RT @USER2022 : how I 'm gunna be when I have a family URL1545	X X PUNCT ADV PRON AUX VERB AUX ADV PRON VERB DET NOUN X
RT @USER1518 : Do n't talk bad about the person when things go south bc at one point in time that 's exactly what you wanted .	X X PUNCT AUX PART VERB ADJ ADP DET NOUN ADV NOUN VERB NOUN NOUN ADP NUM NOUN ADP NOUN PRON AUX ADV PRON PRON VERB PUNCT
Ray Wilkins urges Garde to play Villa \u2019s youngsters ; namechecks one particular talent - HITC #avfc URL498	NOUN NOUN VERB NOUN PART VERB PROPN PART NOUN PUNCT NOUN NUM DET NOUN PUNCT X X X
RT @USER52 : Godfather behind the scenes URL1315	X X PUNCT VERB ADP DET NOUN X
Sushi time in 3 , 2 , 1 ...	NOUN NOUN ADP NUM PUNCT NUM PUNCT NUM PUNCT
RT @USER108 : Such a good thing to have on ur phone . Push the button when u feel unsafe and when u let it go if u do nt enter ur pin they \u2026	X X PUNCT VERB DET ADJ NOUN PART VERB ADP PRON NOUN PUNCT VERB DET NOUN ADV PRON VERB NOUN CCONJ ADV PRON VERB PRON VERB SCONJ PRON AUX PART VERB PRON NOUN PRON PUNCT
RT @USER281 : The Eyenimal Cat Video Camera w/ nightvision ! - URL1052	X X PUNCT DET NOUN NOUN NOUN NOUN X NOUN PUNCT PUNCT X
RT @USER1268 : Can you really make $ 64000 / mo just signing people up with a code ? We review Smash Fund URL1371 URL219 \u2026	X X PUNCT AUX PRON ADV VERB SYM NOUN PUNCT NOUN ADV VERB NOUN ADP ADP DET NOUN PUNCT PRON NOUN X X X X PUNCT
RT @USER814 : This shit hilarious \ud83d\ude02\ud83d\ude02 URL1588	X X PUNCT DET NOUN ADJ SYM X
RT @USER983 : #Trump knows how to make his bank coffers \ Great Again \ right ? What a con artist . URL257	X X PUNCT NOUN VERB ADV PART VERB PRON NOUN NOUN PUNCT ADJ NOUN PUNCT ADV PUNCT PRON DET NOUN NOUN PUNCT X
RT @USER1584 : 15 - year - old youth speaker @USER788 ca n't be silenced . URL1526	X X PUNCT NUM PUNCT NOUN PUNCT ADJ NOUN NOUN NOUN AUX PART AUX NOUN PUNCT X
goal with @USER691 URL431	NOUN ADP NOUN X
RT @USER1330 : Gay Nightclub Shooting The Deadliest In History Of America ! The Mixed Reactions To The Horror Will Shock You ! URL221 \u2026	X X PUNCT ADJ NOUN VERB DET NOUN ADP NOUN ADP PROPN PUNCT DET NOUN NOUN ADP DET NOUN AUX VERB PRON PUNCT X PUNCT
Gerime The Menace ... \ud83d\ude05\ud83d\ude05	VERB DET NOUN PUNCT X
RT @USER454 : Make hundreds of dollars / week playing around on Facebook / Twitter ! URL1636 URL1606	X X PUNCT VERB NOUN ADP NOUN PUNCT NOUN VERB ADP ADP PROPN PUNCT PROPN PUNCT X X
#CareerArc #Retail #Job alert : Manager Trainee - Retail Sales | Speedway | #Brimfield , OH URL664 #Jobs #Hiring	DET NOUN X X PUNCT PROPN NOUN PUNCT NOUN NOUN SYM X SYM X PUNCT INTJ X X X
RT @USER756 : @USER424 Very proud to be in top 3 ' Best places to Work ' , fingers crossed for Thursday - great write up #Awards ht \u2026	X X PUNCT NOUN ADJ ADJ PART AUX ADP NOUN NUM PUNCT ADJ NOUN ADP NOUN PUNCT PUNCT NOUN VERB ADP PROPN PUNCT ADJ VERB ADP NOUN X PUNCT
RT @USER2215 : I agree . I do not HATE Muslims . They have NUMEROUS Muslims majority countries where they can go & be happy . URL222 \u2026	X X PUNCT PRON VERB PUNCT PRON AUX PART ADJ NOUN PUNCT PRON VERB NOUN NOUN X X ADV PRON AUX VERB CCONJ AUX ADJ PUNCT X PUNCT
RT @USER1093 : good ideas URL241	X X PUNCT ADJ NOUN X
Dean still needs more recognition though , but elo and g soul are hella good , I love them URL1239	NOUN ADV VERB ADJ NOUN ADV PUNCT CCONJ NOUN CCONJ X NOUN AUX ADV ADJ PUNCT PRON VERB PRON NOUN
RT @USER2159 : a year later and things have n't changed	X X PUNCT DET NOUN ADV CCONJ NOUN AUX PART VERB
Tickets go on sale in 2 minutes and both my parents are upstairs . I 'm not getting tickets .	NOUN VERB ADP NOUN ADP NUM NOUN CCONJ VERB PRON NOUN AUX NOUN PUNCT PRON AUX PART VERB NOUN PUNCT
@USER642 will score more than #Wade next year and be a better 3pt #shooter than Wade ever was #thankswade #enjoyrondo #goheat #MiamiHeat	NOUN AUX VERB ADJ ADP NOUN ADJ NOUN CCONJ AUX DET ADJ NOUN NOUN ADP NOUN ADV AUX ADJ X X X
Such a beautiful day to be \ atropelado \ - by @USER1638	VERB DET ADJ NOUN PART AUX PUNCT NOUN PUNCT PUNCT ADP NOUN
It 's sad that I had to part ways with my bmcc and Zeiss primes as I had to sell it to pay off my first camera FS 100 as it dropped $ 7 k MSRP	PRON AUX ADJ SCONJ PRON VERB ADP NOUN NOUN ADP PRON NOUN CCONJ NOUN NOUN SCONJ PRON VERB PART VERB PRON PART VERB ADP PRON ADJ NOUN NOUN NUM ADP PRON NOUN SYM NUM NUM SYM
Iphone app gemmation prefab unadulterated \u2013 indivisible guests shines eminent the break : IbcLBe	NOUN NOUN NOUN X X PUNCT X X X X DET NOUN PUNCT X
#Boston #Job Treasury Analyst : MA - Boston , The Treasury Analyst will contribute to the day - to - day financial act ... URL1201	ADJ X X X PUNCT NOUN PUNCT PROPN PUNCT DET NOUN NOUN AUX VERB ADP DET NOUN PUNCT ADP PUNCT NOUN NOUN NOUN PUNCT X
RT @USER1130 : I just drove 4 hours to sleep less than six hours and speak tomorrow morning for 2 minutes . LOL ..... I 'm hooked ! #Toastma \u2026	X X PUNCT PRON ADV NOUN NUM NOUN PART VERB ADV ADP NUM NOUN CCONJ VERB NOUN NOUN ADP NUM NOUN PUNCT INTJ PUNCT PRON AUX NOUN PUNCT X PUNCT
@USER14 FOLLOW & RT to #WIN this stunning @USER285 set for your dad this Father 's Day with 4 x @USER7 . Good Luck !	NOUN VERB CCONJ VERB PART VERB DET NOUN NOUN NOUN ADP PRON NOUN DET NOUN PART NOUN ADP NUM SYM NOUN PUNCT ADJ NOUN PUNCT
RT @USER2416 : Me right now URL1352	X X PUNCT PRON ADV ADV X
RT @USER1822 : My #TeenChoice for #ChoiceModel is @USER507 URL1154	X X PUNCT PRON NOUN ADP NOUN AUX X X
Tombstone will always be my favorite movie .	NOUN AUX ADV AUX PRON ADJ NOUN PUNCT
RT @USER2436 : 1606165 093229 || Scheduling for multiple dates / times to twitter with just text	X X PUNCT NOUN X X NOUN ADP ADJ NOUN PUNCT NOUN PART VERB ADP ADV NOUN
RT @USER708 : We are not saved by any work we 've done , but by the grace and mercy of God .	X X PUNCT PRON AUX PART VERB ADP DET NOUN PRON AUX VERB PUNCT CCONJ ADP DET NOUN CCONJ NOUN ADP PROPN PUNCT
RT @USER1217 : my face vs my soul URL1294	X X PUNCT PRON NOUN ADP PRON NOUN X
RT @USER1246 : depression is n't always at 3 am , sometimes it hits you at 3 pm when you 're with friends , halfway through a laugh and suddenly \u2026	X X PUNCT NOUN AUX PART ADV ADP NUM NOUN PUNCT ADV PRON VERB PRON ADP NUM NOUN ADV PRON AUX ADP NOUN PUNCT VERB ADP DET NOUN CCONJ NOUN PUNCT
@USER2454 @USER1797 @USER1687 I ca n't talk the lass at the hair dressers asked me if she wanted me to trim my brows . #theshame	PROPN PROPN PROPN PRON AUX PART VERB DET NOUN ADP DET NOUN NOUN VERB PRON SCONJ PRON VERB PRON PART VERB PRON NOUN PUNCT X
RT @USER251 : Find the cheapest flights by comparing hundreds of airlines and travel sites URL773 URL1515 \u2026	X X PUNCT VERB DET NOUN NOUN ADP PROPN NOUN ADP NOUN CCONJ NOUN X X X PUNCT
@USER611 @USER2175 add me back too	PROPN NOUN VERB PRON ADV ADV
RT @USER1338 : This is exactly how this song makes me feel lol URL1429	X X PUNCT PRON AUX ADV ADV DET NOUN VERB PRON VERB INTJ X
#Earthquake ( #sismo ) M2.7 strikes 21 km E of #Everett ( #Washington ) 5 min ago . More info : URL1512	NOUN PUNCT NOUN PUNCT NOUN VERB NUM NUM PROPN ADP NOUN PUNCT NOUN PUNCT NUM NOUN ADV PUNCT ADJ NOUN PUNCT X
RT @USER374 : Stay in my life and I swear I 'll stay in yours .	X X PUNCT VERB ADP PRON NOUN CCONJ PRON VERB PRON AUX VERB ADP PRON PUNCT
RT @USER2608 : @USER2488 @USER1906 @USER56 sorry for your loss	X X PUNCT X X X INTJ ADP PRON NOUN
RT @USER961 : Before they tip the #ECF tomorrow , we flash back to #TheAssociation during @USER1100 record - setting season ! URL867	X X PUNCT SCONJ PRON VERB DET NOUN NOUN PUNCT PRON VERB ADV ADP NOUN ADP NOUN NOUN PUNCT VERB NOUN PUNCT X
RT @USER2263 : @USER530 Give me strength to walk on Your principles Guru Ji #HumanityAimsOfMSG	X X PUNCT X VERB PRON NOUN PART VERB ADP PRON NOUN X X X
RT @USER1837 : me : i saw on fb you had a baby friend : ya me : how much does he bench friend : what me : [ leans in to his ear ] how much . doe \u2026	X X PUNCT PRON PUNCT PRON VERB ADP PROPN PRON VERB DET NOUN NOUN PUNCT PRON PRON PUNCT ADV ADV AUX PRON VERB NOUN PUNCT PRON PRON PUNCT PUNCT NOUN ADP ADP PRON NOUN PUNCT ADV ADV PUNCT X PUNCT
This is a serious matter \ud83d\udc95\ud83d\udc9a URL335	PRON AUX DET ADJ NOUN NOUN X
Just paid so many bills FML	ADV VERB ADV ADJ NOUN NOUN
sluts gone wild \u2705 URL420 URL1423	NOUN ADV NOUN X X X
Triangulation Peak , OR [ OC ] [ 2400 x 1714 ] URL646 URL752	NOUN NOUN PUNCT PROPN PUNCT NOUN PUNCT PUNCT NOUN SYM X PUNCT X X
How many of y'all can disagree with someone without calling them out of their name	ADV ADJ ADP NOUN AUX VERB ADP PRON ADP VERB PRON ADP ADP PRON NOUN
I liked a @USER1490 video URL1046 GTA 5 ONLINE - HOW TO SAVE BODYGUARD OUTFITS CLOTHING GLITCH ! [ EASY / NEW ] AFTER PATCH	PRON VERB DET PROPN NOUN NOUN X NUM NOUN PUNCT ADV ADP NOUN NOUN X X NOUN PUNCT PUNCT ADJ PUNCT ADJ PUNCT ADP X
Just sent an invitation to all my friends on Facebook to stop playing Candy Crush and : go hug someone they love .	ADV VERB DET NOUN ADP DET PRON NOUN ADP PROPN PART VERB VERB NOUN NOUN CCONJ PUNCT VERB NOUN PRON PRON VERB PUNCT
RT @USER588 : So happy when I 'm with u \u2764\ufe0f	X X PUNCT ADV ADJ ADV PRON AUX ADP PRON SYM
RT @USER612 : the let 's steal tweets squad URL1022	X X PUNCT DET NOUN PART VERB NOUN NOUN X
A GOOD MOM URL1346	DET ADJ NOUN X
RT @USER2034 : Why is school a thing ? \ud83d\ude43\ud83d\udcda	X X PUNCT ADV AUX NOUN DET NOUN PUNCT X
I 'm bout to text you URL291	PRON AUX VERB PART VERB PRON X
RT @USER2244 : @USER366 @USER1171 @USER2596 Do I have a secret twin sister that you see around the place ? Govian ? Are you kiddi \u2026	X X PUNCT X X X AUX PRON VERB DET NOUN NOUN NOUN SCONJ PRON VERB ADP DET NOUN PUNCT X PUNCT AUX PRON NOUN PUNCT
@USER1708 you 're a great friend to have too ! Thank you \ud83d\ude18\u2764\ufe0f	PROPN PRON AUX DET ADJ NOUN PART VERB ADV PUNCT VERB PRON SYM
RT @USER1066 : MY LIFE #growingupwithsiblings URL1004	X X PUNCT PRON NOUN X X
RT @USER222 : #Ukraine does not recognize court verdicts vs #Sentsov #Afanasyev #Kolchenko #Soloshenko convicted in #Russia URL222 \u2026	X X PUNCT NOUN AUX PART VERB NOUN NOUN ADP PROPN X X X X ADP NOUN X PUNCT
RT @USER2125 : Katy Perry Showing she Her Nips And Camel Toe In A Tight Bikini !!! ( 9 pics ) ////// see here <<<< URL590	X X PUNCT X X VERB PRON PRON NOUN CCONJ NOUN NOUN ADP DET NOUN NOUN PUNCT PUNCT NUM NOUN PUNCT X VERB ADV X X
RT @USER221 : . @USER1434 needs to listen to @USER150 & pay its fair share : URL588 #StandUp2Vz #BetterMatters URL220 \u2026	X X PUNCT PUNCT NOUN VERB PART VERB PART NOUN CCONJ VERB PRON ADJ NOUN PUNCT X X X X PUNCT
RT @USER679 : Mood Asf When I 'm High URL652	X X PUNCT X X ADV PRON AUX ADJ NOUN
RT @USER510 : I stalk myself a lot .. Like I 'll go through my own Twitter , Instagram and watch my story way more than I do anyone else lmao \u2026	X X PUNCT PRON VERB PRON DET NOUN PUNCT VERB PRON AUX VERB ADP PRON ADJ PROPN PUNCT PROPN CCONJ VERB PRON NOUN NOUN ADJ SCONJ PRON VERB PRON VERB INTJ PUNCT
In one state , more children homeschool than attend private schools . Why that should n\u2019t shock you . \u2013 \u2026 URL992 #homeschool	ADP NUM NOUN PUNCT ADJ NOUN NOUN ADP NOUN ADJ NOUN PUNCT ADV PRON AUX PART VERB PRON PUNCT PUNCT PUNCT X X
RT @USER832 : Parents , problems , friends , fakes , love , crush , dating , responsibility , drama , heartache , failures , stress , happiness ; It \u2026	X X PUNCT NOUN PUNCT NOUN PUNCT NOUN PUNCT NOUN PUNCT NOUN PUNCT VERB PUNCT VERB PUNCT NOUN PUNCT NOUN PUNCT NOUN PUNCT NOUN PUNCT VERB PUNCT NOUN PUNCT PRON PUNCT
okay i m watching bates motel byE	INTJ PRON AUX VERB NOUN X X
this is what it 's like to be a vegetarian at school #lent URL547	PRON AUX PRON PRON AUX VERB PART AUX DET ADJ ADP NOUN X X
RT @USER469 : Please share . Missing 18year old is a close friend of my neighbour . URL1028	X X PUNCT INTJ VERB PUNCT NOUN NOUN ADJ AUX DET ADJ NOUN ADP PRON NOUN PUNCT X
A panjabi comment on Pakistan Defense : \ We are in war with Abdalis , Ghorids and Ghazavids . We have named our ... URL551	DET NOUN NOUN ADP NOUN NOUN PUNCT PUNCT PRON AUX ADP NOUN ADP NOUN PUNCT NOUN CCONJ NOUN PUNCT PRON VERB VERB PRON PUNCT X
RT @USER852 : New patch will be live tomorrow ! We will live stream during #weekend with #giveaway codes ! check out the #indiegame URL221 \u2026	X X PUNCT ADJ NOUN AUX AUX ADJ NOUN PUNCT PRON AUX VERB NOUN ADP NOUN ADP NOUN NOUN PUNCT VERB ADP DET NOUN X PUNCT
RT @USER65 : I want Wayne Gooney 2 come back on twitter & tell me all the players Wenger is going to sign again ... I miss him terribly # \u2026	X X PUNCT PRON VERB PROPN NOUN NUM VERB ADV ADP PROPN CCONJ VERB PRON DET DET NOUN PROPN AUX VERB PART VERB ADV PUNCT PRON VERB PRON NOUN NOUN PUNCT
RT @USER101 : The Walk - Falling Leaves - Vincent van Gogh , 1889 URL1212	X X PUNCT DET NOUN PUNCT VERB NOUN PUNCT X PROPN X PUNCT X X
Almost as beautiful as you are conceited , she thought at him , and he laughed out loud .	NOUN ADP ADJ SCONJ PRON AUX NOUN PUNCT PRON VERB ADP PRON PUNCT CCONJ PRON VERB ADP NOUN PUNCT
Spend 80 on a watch she call me Dada	VERB NUM ADP DET NOUN PRON VERB PRON X
Stolen Christopher Columbus Letter Returned to Italy - Discovery News : Discovery NewsStolen Christopher Colum ... URL274	NOUN NOUN PROPN PROPN NOUN ADP NOUN PUNCT NOUN NOUN PUNCT X X X X PUNCT X
RT @USER1470 : Lord , lead me so I can lead others .	X X PUNCT PROPN PUNCT VERB PRON ADV PRON AUX VERB NOUN PUNCT
RT @USER1436 : Him : Can you be serious for a moment Me : URL737	X X PUNCT NOUN PUNCT AUX PRON AUX ADJ ADP DET NOUN PRON PUNCT X
@USER171 @USER1134 do you realize that if Jimmy G gets hurt all they have left is Brissett ? Are they really not signing a veteran ?	PROPN NOUN AUX PRON VERB PRON SCONJ NOUN PROPN VERB VERB DET PRON VERB ADJ AUX NOUN PUNCT AUX PRON ADV PART VERB DET NOUN PUNCT
@USER77 \ud83d\ude4f\ud83c\udffb thank god	PROPN PROPN VERB NOUN
Return all the money you stole from Kofi Amoabeng \u2019s drawer \u2013 Diamond \u2018 slaps \u2019 Mzbel URL1379 URL1325	VERB DET DET NOUN PRON VERB ADP PROPN X PART NOUN PUNCT PROPN PUNCT X PUNCT X X X
RT @USER1020 : I hate saying this but uhh \ I still love you \ .	X X PUNCT PRON VERB VERB PRON CCONJ NOUN PUNCT PRON ADV VERB PRON PUNCT PUNCT
RT @USER1072 : Come to the dark side . #BrexitIn5Words URL322	X X PUNCT VERB ADP DET ADJ NOUN PUNCT X X
RT @USER2049 : \ Jesus said ' At the moment you do not know what I am doing , but later you will understand . ' \ - John 13:7	X X PUNCT PUNCT PROPN VERB PUNCT ADP DET NOUN PRON AUX PART VERB PRON PRON AUX VERB PUNCT CCONJ ADV PRON AUX VERB PUNCT PUNCT PUNCT PUNCT PROPN X
Congratulatory message for Kstyle 's 4 years ! URL538	NOUN NOUN ADP NOUN PART NUM NOUN PUNCT X
RT @USER957 : What 's real does n't fade away .	X X PUNCT PRON AUX ADJ AUX PART VERB ADV PUNCT
RT @USER2202 : oh nazuna was actually thinking of going back to valkyrie after ra*bits gets on the right track but he does n't want to leave \u2026	X X PUNCT INTJ NOUN AUX ADV VERB ADP VERB ADV ADP NOUN ADP NOUN VERB ADP DET NOUN NOUN CCONJ PRON AUX PART VERB PART VERB PUNCT
RT @USER1882 : old enough URL796	X X PUNCT ADJ ADJ NOUN
RT @USER498 : Crikey ! Manchester United have sacked Louis Van Gaal . Who saw that coming ? Next thing you know they 'll appoint Jos\u00e9 Mourin \u2026	X X PUNCT NOUN PUNCT PROPN PROPN VERB NOUN PROPN PROPN PROPN PUNCT PRON VERB PRON VERB PUNCT ADJ NOUN PRON VERB PRON AUX ADJ X X PUNCT
By Pass ! #np	ADP NOUN PUNCT X
Hold up ?! Knicks beat Bulls back to back ?!	VERB ADP PUNCT NOUN VERB PROPN ADV ADP ADV PUNCT
RT @USER833 : ME - YOU URL1366	X X PUNCT PRON PUNCT PRON NOUN
I am playing Online Head Ball with real players . Download now : URL405 #OnlineHeadball #HeadBall	PRON AUX VERB ADJ NOUN NOUN ADP ADJ NOUN PUNCT NOUN ADV PUNCT X X X
RT @USER1352 : Like a proud papa silverback , just look at this talented cool / hot #Baywatch cast .. ilfenator , \u2026 URL1523	X X PUNCT VERB DET ADJ NOUN NOUN PUNCT ADV VERB ADP DET ADJ ADJ PUNCT ADJ NOUN NOUN PUNCT X PUNCT PUNCT X
RT @USER2074 : Whoa . This letter from @USER2550 on the FBI request is incredible and unprecedented . Read it now . URL1185 \u2026	X X PUNCT NOUN PUNCT DET NOUN ADP NOUN ADP DET PROPN NOUN AUX ADJ CCONJ NOUN PUNCT VERB PRON ADV PUNCT X PUNCT
If you were an elevator , what button would I have to push to get you to go down ? #MyBestPickupLines	SCONJ PRON AUX DET NOUN PUNCT PRON NOUN AUX PRON VERB PART VERB PART VERB PRON PART VERB ADV PUNCT X
RT @USER137 : \ Not that we lord it over your faith , but we work with you for your joy . \ 2 Corinthians 1:24 #GoodFaith URL533 \u2026	X X PUNCT PUNCT ADV PRON PRON NOUN PRON ADP PRON NOUN PUNCT CCONJ PRON VERB ADP PRON ADP PRON NOUN PUNCT PUNCT NUM NOUN X X X PUNCT
RT @USER1137 : British @USER1861 astronaut #TimPeake meets Apollo 15 @USER960 astronaut Al Worden ! #Astronaut #Apollo15 #FIA16 URL1589 \u2026	X X PUNCT ADJ NOUN X X X X NUM NOUN X PROPN NOUN PUNCT X X X X PUNCT
RT @USER2132 : Tell Me What Is Love - D.O ( from EXO ) URL170	X X PUNCT VERB PRON PRON AUX VERB PUNCT NOUN PUNCT ADP NOUN PUNCT X
RT @USER569 : Word URL330	X X PUNCT PROPN X
A cracking in the pattern , a miracle waiting to happen URL285	DET NOUN ADP DET NOUN PUNCT DET NOUN VERB PART VERB X
Just posted a photo URL774	ADV VERB DET NOUN X
RT @USER2081 : Justin Bieber 's Statements About Selena Gomez Will Forever Smash Her Hopes And Dreams see URL927 URL218 \u2026	X X PUNCT PROPN PROPN PART NOUN ADP NOUN NOUN AUX ADV VERB PRON NOUN CCONJ NOUN VERB X X PUNCT
RT @USER1193 : dis could be us but you praying URL318	X X PUNCT PRON AUX AUX PRON CCONJ PRON VERB X
RT @USER2018 : I hate when chicks be like \ At the end of the day he coming home \ud83c\udfe0 to me \ \ud83d\udc81\ud83c\udffe ... DUH !! bitch she ai n't letting his ass stay ov \u2026	X X PUNCT PRON VERB ADV NOUN AUX VERB PUNCT ADP DET NOUN ADP DET NOUN PRON VERB ADV NOUN ADP PRON PUNCT NOUN PUNCT X PUNCT NOUN PRON AUX PART VERB PRON NOUN VERB NOUN PUNCT
RT @USER102 : If you want people to pay to win , make a pay to play game . Do n't pretend that the game is playable for free if you have to \u2026	X X PUNCT SCONJ PRON VERB NOUN PART VERB PART VERB PUNCT VERB DET NOUN PART VERB NOUN PUNCT AUX PART VERB DET DET NOUN AUX NOUN ADP ADJ SCONJ PRON VERB ADP PUNCT
@USER254 they do n't have anything on you bc you 're a bomb ass person \ud83d\ude34\ud83d\ude18	NOUN PRON AUX PART VERB PRON ADP PRON SCONJ PRON AUX DET NOUN NOUN NOUN X
@USER795 nice and cool 72 in my ac fitted home . Should invest . The world@is@only getting warmer	NOUN ADJ CCONJ ADJ NUM ADP PRON NOUN NOUN ADV PUNCT AUX VERB PUNCT DET NOUN VERB X
RT @USER333 : Sometimes I feel like we 're friends , sometimes I feel like we 're more than friends , but sometimes I feel like I 'm just a \u2026	X X PUNCT VERB PRON VERB SCONJ PRON AUX NOUN PUNCT ADV PRON VERB SCONJ PRON AUX ADJ ADP NOUN PUNCT CCONJ ADV PRON VERB SCONJ PRON AUX ADV DET PUNCT
RT @USER628 : Mala tomorrow land \ud83d\ude02\ud83d\ude02 DUTERTE GRAND RALLY URL1378	X X PUNCT X NOUN X X X X X X
Pumping up for game day and Shannon nole comes on	VERB ADP ADP NOUN NOUN CCONJ NOUN NOUN VERB ADP
Marco interrupts the yoga onstage at the #GOPDebate as #Cruz tells #Trump to #breathe . #pranayama for #politicians URL982	PROPN VERB DET NOUN NOUN ADP DET NOUN ADP NOUN VERB NOUN ADP NOUN PUNCT X ADP NOUN X
@USER1339 \u2014 been thwarted whenever they had taken a look at his wings . Something so angelic but in their eyes , he was a monster . \u2014	NOUN PUNCT AUX NOUN ADV PRON VERB VERB DET NOUN ADP PRON NOUN PUNCT NOUN ADV NOUN CCONJ ADP PRON NOUN PUNCT PRON AUX DET NOUN PUNCT PUNCT
@USER1281 @USER1302 handle me with care	NOUN NOUN VERB PRON ADP NOUN
RT @USER1770 : do n't wan na talk to anyone	X X PUNCT AUX PART VERB PART VERB ADP PRON
. @USER536 thanks for the latest #ThreatWire video - ATM skimming up 546 % URL1600	PUNCT NOUN NOUN ADP DET ADJ NOUN NOUN PUNCT NOUN NOUN ADP NOUN SYM X
@USER2053 @USER917 could n't it be considered a positive that it 's not news when something like this happens ?	PROPN NOUN AUX PART PRON AUX VERB DET NOUN SCONJ PRON AUX PART NOUN ADV PRON VERB PRON NOUN PUNCT
RT @USER2167 : \ You better ride that dick like a soldier \ URL634	X X PUNCT PUNCT PRON ADJ VERB DET NOUN ADP DET NOUN PUNCT X
Dover riots : Protesters burnt EU flag as migration anger spirals out of control URL1142	ADJ NOUN PUNCT NOUN NOUN VERB NOUN ADP NOUN NOUN NOUN ADP ADP NOUN X
RT @USER2051 : RT to WIN : ABH 's Moon Child glow kit :) mbf URL1584	X X PUNCT VERB ADP VERB PUNCT X PART NOUN NOUN NOUN X SYM X X
@USER147 Okay , but why ?	PROPN INTJ PUNCT CCONJ ADV PUNCT
There is too many humans here \ud83d\udc7d	PRON AUX ADV ADJ NOUN ADV X
RT @USER2433 : idc what anyone says , it s ok to pay for ya mans meal sometimes . Now a days girls so pressed on the fact that the guy got ta \u2026	X X PUNCT INTJ PRON PRON VERB PUNCT PRON AUX ADJ PART VERB ADP PRON NOUN NOUN ADV PUNCT ADV DET NOUN NOUN ADV VERB ADP DET NOUN DET DET NOUN VERB PART PUNCT
RT @USER396 : Instead of telling everyone about feelings , I choose to keep it all insides by me . Because ppl keep leaving me , I know .	X X PUNCT VERB ADP VERB PRON ADP NOUN PUNCT PRON VERB PART VERB PRON DET NOUN ADP PRON PUNCT SCONJ NOUN VERB VERB PRON PUNCT PRON VERB PUNCT
My head hurts ..........	PRON NOUN NOUN X
RT @USER2083 : Bitches live for the internet flex \ud83d\ude29	X X PUNCT VERB VERB ADP DET NOUN NOUN X
The revolution may be televised ...	DET NOUN AUX AUX NOUN PUNCT
URL844 Cadet World Team training at Harwich , fantastic weather , a great team .... yes this is Great Britain @USER486	PROPN NOUN PROPN NOUN NOUN ADP NOUN PUNCT NOUN NOUN PUNCT DET ADJ NOUN PUNCT INTJ PRON AUX ADJ PROPN X
RT @USER1501 : If elected Mayor , I 'll improve London 's living environment . Add your name to back my plan : URL1385 URL218 \u2026	X X PUNCT SCONJ NOUN NOUN PUNCT PRON AUX VERB PROPN PART VERB NOUN PUNCT VERB PRON NOUN PART ADV PRON NOUN PUNCT X X PUNCT
Lowe 's purchase of RONA positive for ... : LITTLE CURRENT \u2014 American retailing giant Lowe 's Company Inc. is purcha ... URL958	NOUN PART NOUN ADP NOUN NOUN ADP PUNCT PUNCT X X PUNCT ADJ NOUN ADJ NOUN PART PROPN NOUN AUX NOUN PUNCT X
\u201c @USER1939 : Call yo friends let 's get DRUNK \ud83d\ude1b URL919 \u201d	PUNCT NOUN PUNCT VERB PRON NOUN VERB PART VERB NOUN X X PUNCT
RT @USER2056 : for a wife , for a husband . To whoever you date ; are they the one or are you just playing games ? URL802	X X PUNCT ADP DET NOUN PUNCT ADP DET NOUN PUNCT PART NOUN PRON NOUN PUNCT AUX PRON DET NOUN CCONJ AUX PRON ADV VERB NOUN PUNCT X
@USER850 is @USER2377 3rd wife and his children are from all three not very Christian	NOUN AUX VERB NOUN NOUN CCONJ PRON NOUN AUX ADP DET NUM ADV ADV ADJ
RT @USER393 : [ ! ] 160601 EXO 's 3rd full length album is titled EX ' ACT URL320	X X PUNCT PUNCT PUNCT PUNCT X X PART NOUN ADJ NOUN NOUN AUX ADJ X PUNCT X X
RT @USER281 : Cat Scared Of Vacuum Cleaner | Funny Video Cat 2016 | Meo Cover House - URL305	X X PUNCT NOUN ADJ ADP NOUN NOUN SYM ADJ NOUN NOUN NUM SYM X PROPN NOUN PUNCT X
RT @USER2276 : The Dark Secrets Of ' Full House ' Will Blow Your Mind URL1296	X X PUNCT DET NOUN NOUN ADP PUNCT ADJ NOUN PUNCT VERB VERB PRON NOUN X
Exclusive first look at Cross Border VAT on Thursday 12th May URL995	ADJ ADJ VERB ADP NOUN NOUN NOUN ADP PROPN NOUN NUM X
' House of Cards ' season 5 spoilers : Claire destroys Frank while Doug finds love in new season ? - ChristianToday URL1055	PUNCT NOUN ADP NOUN PUNCT NOUN NUM NOUN PUNCT X X PROPN SCONJ PROPN VERB NOUN ADP ADJ NOUN PUNCT PUNCT X X
That flash tho x2 URL1323	PRON NOUN ADV SYM X
Csgo #ELEAGUE live on #tbs !!!!!!! URL1571	NOUN NOUN VERB ADP NOUN PUNCT X
@USER622 \ I think you are fortunate she has a tender heart . I would suffer her wrath if we fought . But I am watching you . \	NOUN PUNCT PRON VERB PRON AUX VERB PRON VERB DET NOUN NOUN PUNCT PRON AUX VERB PRON NOUN SCONJ PRON NOUN PUNCT CCONJ PRON AUX VERB PRON PUNCT PUNCT
RT @USER1544 : 3 more months until graduation \ud83d\udc83\ud83c\udfff	X X PUNCT NUM ADJ NOUN ADP X X
RT @USER128 : GIMME URL283	X X PUNCT X X
#LetterFromTheBrooks please choose me , a will frame it & put it on my wall \ud83d\udcc3 !!!!! I love & miss use sm \ud83d\ude18 @USER1368 \ud83d\ude07	PROPN INTJ VERB PRON PUNCT DET AUX VERB PRON CCONJ VERB PRON ADP PRON NOUN NOUN PUNCT PRON VERB CCONJ VERB VERB X SYM X X
RT @USER2180 : How much longer can @USER1037 ignore #USURY and #PAEDOPHILA and hide #EMBRYOLOGY from MOTHERS ? Such simple math / science . @ \u2026	X X PUNCT ADV ADV ADV AUX VERB VERB NOUN CCONJ NOUN CCONJ VERB NOUN ADP NOUN PUNCT VERB ADJ NOUN PUNCT NOUN PUNCT ADP PUNCT
Ok done being sap . Here 's Zola waiting for her treat \ud83d\udc36 URL1337	INTJ ADV AUX NOUN PUNCT ADV PART NOUN VERB ADP PRON NOUN X X
RT @USER1186 : RT IF #GreenWall URL643	X X PUNCT X PRON X X
URL490 Temp : 8.7 \u00b0C Wind : 6.9 mph Pressure : 1010.6 mb Falling Rain Today 0.0 mm Hum 69 % Fc : Occasional precipitation , worsening	ADJ NOUN PUNCT NOUN NOUN NOUN PUNCT NOUN X X PUNCT X NOUN VERB NOUN NOUN NUM NUM NOUN NOUN SYM X PUNCT X X PUNCT X
RT @USER2016 : Bellerin was member in PFA team of a year and Ismed Sofyan can deliver much better cross than him .	X X PUNCT NOUN AUX NOUN ADP NOUN NOUN ADP DET NOUN CCONJ NOUN NOUN AUX VERB ADV ADJ NOUN ADP PRON PUNCT
finna hit him with that \ you up \ text \ud83d\ude29	NOUN VERB PRON ADP PRON PUNCT PRON ADP PUNCT NOUN SYM
RT @USER2598 : \ when did you start crying ? \ URL835	X X PUNCT PUNCT ADV VERB PRON VERB VERB PUNCT PUNCT X
@USER1844 @USER2432 we all know that jen wants jimin :)	PROPN NOUN PRON DET VERB PRON NOUN VERB NOUN SYM
RT @USER448 : These crossover episodes were lit URL974	X X PUNCT DET NOUN NOUN AUX ADJ X
@USER1446 what ? \ud83d\ude02\ud83d\ude02\ud83d\ude02	VERB PRON PUNCT SYM
RT @USER1445 : The world not ready URL1605	X X PUNCT DET NOUN PART ADJ X
RT @USER914 : Never give up on someone you ca n't go a day without thinking about .	X X PUNCT ADV VERB ADP ADP PRON PRON AUX PART VERB DET NOUN ADP VERB ADP PUNCT
Lee Joon fights the temptation to suck ? URL583 #kpop #kpopmusic	PROPN NOUN VERB DET NOUN ADP NOUN PUNCT X X X
AllGreen News : URL276 Top posts from : @USER1716 @USER319	NOUN NOUN PUNCT NOUN ADJ NOUN ADP PUNCT X X
Shades Of Childhood Ruined , Make Sure You Close Your Eyes URL1291 URL1236	NOUN ADP NOUN NOUN PUNCT VERB INTJ PRON VERB PRON NOUN X X
Philips B 120 In.Sight Wireless HD Baby Monitor For IOS iPad iPhone Camera URL1089	NOUN AUX ADJ NOUN NOUN NOUN NOUN NOUN ADP NOUN NOUN PROPN NOUN X
@USER2641 actually let all ships in svtfoe be platonic	NOUN ADV VERB DET NOUN ADP NOUN AUX X
RT @USER2160 : 4x cause i liked my outfit from yesterday \ud83d\udc99 URL991	X X PUNCT NOUN SCONJ PRON VERB PRON NOUN ADP NOUN SYM X
Kingpin killed as robbers , police engage in shootout in Aba URL1632	NOUN VERB ADP NOUN PUNCT NOUN NOUN ADP NOUN ADP NOUN X
@USER2108 I wan na comment on your lovely smile but Dems gets all my attention . His unlooking is TIGHT !	PROPN PRON VERB PART VERB ADP PRON ADJ NOUN CCONJ VERB VERB DET PRON NOUN PUNCT PRON NOUN AUX NOUN PUNCT
You ai n't lying b \ud83d\ude02\ud83d\ude02 URL511	PRON AUX PART VERB CCONJ SYM X
RT @USER972 : When are we going to run out of usernames ?	X X PUNCT ADV AUX PRON VERB PART VERB ADP ADP NOUN PUNCT
RT @USER1697 : Follow everyone who retweets this \ud83d\udc40	X X PUNCT VERB PRON PRON VERB PRON NOUN
Multibionta 50 + Tablets - 30 Tablets - Pack of 2 - URL1529	NOUN NUM SYM NOUN PUNCT NUM NOUN PUNCT NOUN ADP NUM PUNCT X
@USER1379 hi tisha hope you and your family are well take care \ud83d\ude00 xxxdavid	PROPN INTJ NOUN VERB PRON CCONJ PRON NOUN AUX ADV VERB NOUN SYM X
@USER194 #FiresideBricky meal . Chicken noodle soup and chai tea . URL669	NOUN NOUN NOUN PUNCT NOUN NOUN NOUN CCONJ NOUN NOUN PUNCT X
RT @USER2112 : The heart wants what it wants	X X PUNCT DET NOUN VERB PRON PRON VERB
RT @USER1570 : if i cry in front of you , just know , i reached my limit	X X PUNCT SCONJ PRON VERB ADP NOUN ADP PRON PUNCT ADV VERB PUNCT PRON VERB PRON NOUN
I left my yeti cup at my house this morning and come back to it just now to see that there is still ice in it \ud83d\ude0d\ud83d\udc4d\ud83c\udffc	PRON VERB PRON NOUN NOUN ADP PRON NOUN DET NOUN CCONJ VERB ADV ADP PRON ADV ADV PART VERB PRON PRON AUX ADV VERB ADP PRON NOUN
Fuck sake Ronaldo \ud83d\ude20 #Euros2016	INTJ NOUN NOUN X X
@USER1387 what that mouth do	VERB PRON PRON NOUN AUX
RT @USER352 : HOW DOES BEN SIMMONS MAKE THIS PASS ? URL929	X X PUNCT ADV NOUN NOUN X VERB PRON NOUN PUNCT X
@USER555 these kids on UMG but we won first then my teammates host was shit and last map went round 11	VERB DET NOUN ADP NOUN CCONJ PRON VERB ADV ADV PRON NOUN NOUN AUX NOUN CCONJ ADJ NOUN VERB VERB NUM
RT @USER472 : \ How old are u ? \ * says age * \ Awwww u r a baby ! \ URL416	X X PUNCT PUNCT ADV ADJ AUX PRON PUNCT PUNCT PUNCT VERB NOUN PUNCT PUNCT VERB PRON AUX DET NOUN PUNCT PUNCT X
@USER1469 I watched the first three seasons , and i really liked it lol . Have nt seen it since though , i do nt watch much tv anymore .	PROPN PRON VERB DET ADJ NUM NOUN PUNCT CCONJ PRON ADV VERB PRON INTJ PUNCT AUX PART VERB PRON ADV ADV PUNCT PRON AUX PART VERB ADV NOUN ADV PUNCT
RT @USER871 : me as an eyeshadow URL1543	X X PUNCT PRON ADP DET NOUN X
I found 494 people do not follow me back ( via URL1135 )	PRON VERB NOUN NOUN AUX PART VERB PRON ADV PUNCT ADP NOUN PUNCT
@USER183 do n't think the team had much say in where they drafted .	NOUN AUX PART VERB DET NOUN VERB ADV VERB ADP ADV PRON NOUN PUNCT
RT @USER541 : What if his name was James boob instead of James Bond haha	X X PUNCT PRON SCONJ PRON NOUN AUX PROPN NOUN ADV ADP PROPN PROPN INTJ
@USER190 @USER2091 she does nt read email , only k3 - mail and KKC - mail	PROPN PROPN PRON AUX PART VERB NOUN PUNCT ADV NOUN PUNCT NOUN CCONJ NOUN PUNCT NOUN
Cuba does n\u2019t have trendy food trucks as some places do , but it does have an outdoor hot dog stand if you are ... URL1489	PROPN AUX PART VERB VERB NOUN NOUN ADP DET NOUN VERB PUNCT CCONJ PRON AUX VERB DET ADJ ADJ NOUN VERB SCONJ PRON AUX PUNCT X
RT @USER1263 : by Finbarr Notte , inspired in the amazing beauty of #lacandelaviva #streetart @USER2141 @USER1888 URL574 \u2026	X X PUNCT ADP PROPN NOUN PUNCT VERB ADP DET ADJ NOUN ADP NOUN X X X X PUNCT
Be first to apply - Retail Store Manager in Santa Cruz , CA URL984 #job	AUX ADJ ADP VERB PUNCT NOUN X NOUN ADP PROPN PROPN PUNCT PROPN X X
Gamer thug tears URL519	NOUN NOUN NOUN NOUN
RT @USER426 : RT @USER655 : Day 1 of install at #FDIC2016 URL1215	X X PUNCT X X PUNCT NOUN NUM ADP NOUN ADP NOUN X
RT @USER1443 : \ I hate Donald Trump \ URL1255	X X PUNCT PUNCT PRON VERB PROPN PROPN PUNCT X
RT @USER2597 : THE SEX SCENE URL383	X X PUNCT DET NOUN X X
not going to change ...... lol	PART VERB PART VERB NOUN INTJ
RT @USER1199 : Tonight the @USER1200 World Tour kicks off with #ShawnWorldTourCologne \ud83d\ude46\ud83c\udffb URL1629	X X PUNCT VERB DET ADJ PROPN NOUN NOUN ADP ADP NOUN X X
RT @USER1275 : @USER737 @USER1807 I like that \ United States of America V Pete Santili \ hahahaha #Oregonstandoff	X X PUNCT NOUN X PRON VERB PRON PUNCT PROPN PROPN ADP PROPN PROPN NOUN X PUNCT INTJ X
' Pepper Spray Cop ' Gets $ 38,000 in Workers ' Comp URL702	PUNCT NOUN NOUN NOUN PUNCT NOUN SYM NOUN ADP NOUN PUNCT X X
Expect you to change it , but I like Roman . It 'll forever remind me about earlier . \ @USER794	VERB PRON PART VERB PRON PUNCT CCONJ PRON VERB NOUN PUNCT PRON AUX ADV VERB PRON ADP NOUN PUNCT PUNCT X
I need a new phone case \ud83d\ude16	PRON VERB DET ADJ NOUN NOUN X
RT @USER1102 : Thanks to U.S. Imperialism and Racism , Attacks on Muslims in Europe Increase - URL1332 URL424 \u2026	X X PUNCT NOUN ADP PROPN NOUN CCONJ NOUN PUNCT NOUN ADP NOUN ADP NOUN NOUN PUNCT X X PUNCT
RT @USER1150 : Qualify for a Place at the #AV/IT Leadership Summit , Aug 10 - 11 , in NYC #AVtweeps URL1127	X X PUNCT NOUN ADP DET NOUN ADP DET NOUN NOUN NOUN PUNCT PROPN NUM PUNCT NUM PUNCT ADP NOUN X X
@USER203 waiting for buses to celebrate #July4Canada URL1608	NOUN VERB ADP NOUN PART VERB NOUN X
RT @USER1047 : Rockstar in pune URL354	X X PUNCT NOUN ADP NOUN X
RT @USER1808 : get yourself a girl who can do both URL937	X X PUNCT VERB PRON DET NOUN PRON AUX VERB DET NOUN
RT @USER2043 : #GrowingUpUgly #GrowingUpFat Not having crushes because you automatically know they 're not gon na like you back	X X PUNCT NOUN NOUN PART VERB NOUN SCONJ PRON ADV VERB PRON AUX PART VERB PART SCONJ PRON ADV
@USER1788 this weekend will be good tho	VERB DET NOUN AUX AUX ADJ ADV
I leave for college in 51 days \ud83d\ude1d\ud83d\ude1d	PRON VERB ADP NOUN ADP NOUN NOUN X
Iron Man , the Hulk and Frozen 's Anna arrested in New York - Evening Express URL297 via @USER421	NOUN NOUN PUNCT DET NOUN CCONJ NOUN PART PROPN NOUN ADP ADJ PROPN PUNCT X X X ADP X
did we bother to ask if we should \u2019ve let this happen URL1622	AUX PRON VERB PART VERB SCONJ PRON AUX VERB VERB PRON VERB X
RT @USER2386 : do U think uber drivers get lonely when their passengers leave	X X PUNCT AUX PRON VERB NOUN NOUN VERB NOUN ADV PRON NOUN VERB
RT @USER1868 : My #TeenChoice for #ChoiceModel is @USER507	X X PUNCT PRON NOUN ADP NOUN AUX X
@USER245 both	NOUN DET
#Taurus Dolls make awesome moms ! They 're strict and loving .	PROPN NOUN VERB ADJ NOUN PUNCT PRON AUX NOUN CCONJ VERB PUNCT
Driver continuing to drive around 60 - 65 miles an hour on 91 Eastbound . @USER210 #KCAL9	NOUN NOUN PART NOUN ADP NUM PUNCT NOUN NOUN DET NOUN ADP NOUN NOUN PUNCT X X
RT @USER525 : Our tennis warm up \ud83c\udfbe @USER300 URL948	X X PUNCT PRON NOUN ADJ ADP NOUN X X
[ eBay.ca ] Nexus 5x $ 31 free shipping URL327 URL1250	PUNCT NOUN PUNCT X NOUN SYM NUM ADJ NOUN X X
so at least I broke 1600 . Still sad I did n't make 1700 though . If only I had good teammates earlier , then I probably would 've made it	ADV ADV ADV PRON VERB NOUN PUNCT ADV ADJ PRON AUX PART VERB NOUN ADV PUNCT SCONJ ADV PRON VERB ADJ NOUN NOUN PUNCT ADV PRON ADV AUX AUX VERB PRON
@USER2140 oh shoot I ai n't getting that I need to look poppin in flash pics	PROPN INTJ NOUN PRON AUX PART VERB SCONJ PRON VERB PART VERB NOUN ADP NOUN NOUN
Let your workings remain a mystery . Just show people the results . - Lao - tzu URL602	VERB PRON NOUN NOUN DET NOUN PUNCT ADV NOUN NOUN DET NOUN PUNCT PUNCT X PUNCT X X
RT @USER766 : RT for the chance to WIN this Minority Report inspired T-shirt before we officially release it . URL870	X X PUNCT VERB ADP DET NOUN PART VERB DET NOUN NOUN NOUN NOUN SCONJ PRON NOUN VERB PRON PUNCT X
RT @USER1193 : If you do n't think your friends have the ability to break your heart , you are so so wrong .	X X PUNCT SCONJ PRON AUX PART VERB PRON NOUN VERB DET NOUN PART VERB PRON NOUN PUNCT PRON AUX ADV ADV ADJ PUNCT
RT @USER2039 : At this point I do n't care if I 'm rude to guys like what part do n't ya fucking understand I do n't wan na talk to anyone	X X PUNCT ADP DET NOUN PRON AUX PART VERB SCONJ PRON AUX VERB PART NOUN SCONJ PRON NOUN AUX PART PRON ADV VERB PRON AUX PART VERB PART VERB ADP PRON
@USER2179 Help us win & rt these 2 links please ? Thank you & have an amazing day ! \ud83d\udc95 URL798 URL853	NOUN VERB PRON VERB CCONJ VERB DET NUM NOUN INTJ PUNCT VERB PRON CCONJ VERB DET ADJ NOUN PUNCT X X X
They are so cute . Congratulations . May Allah continue to bless your union . We need more cuties oh URL584	PRON AUX ADV ADJ PUNCT NOUN PUNCT PROPN PROPN VERB PART VERB PRON NOUN PUNCT PRON VERB ADV NOUN INTJ X
Delhi air will never be safe because of its geographical disadvantage : panel to HC URL1614	NOUN NOUN AUX ADV AUX ADJ ADV ADP DET NOUN NOUN PUNCT X ADP X X
Bullet with butterfly wings .	NOUN ADP NOUN NOUN PUNCT
When BB is perfect \ud83d\ude29\ud83d\ude0d\ud83d\ude4c @USER1548 URL458	ADV NOUN AUX ADJ NOUN X X
@USER1026 PLEASE EXPLAIN TO ME WHY YOU TELLING ME TO SHUT UP WILL ACTUALLY GET ME TO SHUT UP	PROPN INTJ VERB ADP PRON ADV PRON VERB PRON PART NOUN ADP AUX VERB VERB PRON ADP NOUN ADP
RT @USER1549 : \ wyd this weekend ? \ URL871	X X PUNCT PUNCT VERB DET NOUN PUNCT PUNCT X
Thankful for another 24	NOUN ADP DET NUM
@USER1833 Imma stay at your pad	NOUN VERB VERB ADP PRON NOUN
um can one of my friends pick me up so we can go riding around & talking ?	INTJ AUX NUM ADP PRON NOUN VERB PRON ADP ADV PRON AUX VERB VERB ADP CCONJ VERB PUNCT
@USER881 I suspect @USER786 's involvement now :/	PROPN PRON VERB NOUN PART NOUN ADV SYM
RT @USER1280 : This is your chance to ask question to LizQuen using ASK TatakLizQuen DolceAmore GrandFansDate #VoteEnriqueFPP #KCA URL0 \u2026	X X PUNCT PRON AUX PRON NOUN PART VERB NOUN PART NOUN VERB X X X X X X X PUNCT
RT @USER1262 : Your child reading before kindergarten ! This guide can make it happen #kindergarten #ASMSG URL459	X X PUNCT PRON NOUN VERB ADP NOUN PUNCT DET NOUN AUX VERB PRON VERB X X X
RT @USER1805 : Check out my article about Darren Espanto : URL1153 @USER1025 URL277	X X PUNCT VERB ADP PRON NOUN ADP NOUN X PUNCT X X X
RT @USER1241 : When Taeyeon went on the lift during \ U R \ and confetti fell , Yoona 's jaw dropped and she took a video of it . URL224 \u2026	X X PUNCT ADV NOUN VERB ADP DET NOUN NOUN PUNCT PRON X PUNCT CCONJ NOUN VERB PUNCT PROPN PART NOUN NOUN CCONJ PRON VERB DET NOUN ADP PRON PUNCT X PUNCT
Excellent condition 1 BR in an Elevator building ( Gramercy ) $ 3825 1 bd URL478 URL575 #roommate	NOUN NOUN NUM NOUN ADP DET NOUN NOUN PUNCT NOUN PUNCT SYM NOUN NUM X X X X
URL988 Hey ! Check URL1640 for latest cs:go giveaways , free and no sign up needed ;)	PROPN INTJ PUNCT VERB NOUN ADP ADJ NOUN NOUN PUNCT ADJ CCONJ DET NOUN ADP VERB SYM
RT @USER25 : Laurmani in red appreciation tweet #VeranoMTV2016 Fifth Harmony URL585	X X PUNCT NOUN ADP ADJ NOUN NOUN X X PROPN X
@USER2400 you thought	VERB PRON VERB
RT @USER1702 : hate is never the answer .	X X PUNCT VERB AUX ADV DET NOUN PUNCT
RT @USER1320 : VIDEO : Russian jets violently disrupt Free Syrian Army ceremony in western #Daraa URL402 URL1544 \u2026	X X PUNCT NOUN PUNCT X X X X ADJ NOUN X NOUN ADP ADJ NOUN X X PUNCT
RT @USER2545 : When you go through deep waters , I will be with you . Isaiah 43:2	X X PUNCT ADV PRON VERB ADP ADJ NOUN PUNCT PRON AUX AUX ADP PRON PUNCT X X
How many of you really knows that today is my birthday \ud83d\ude0d\ud83d\ude0d - No I know URL1611	ADV ADJ ADP PRON ADV VERB PRON NOUN AUX PRON NOUN NOUN PUNCT DET PRON VERB X
#CD #Music On the 6 , #JenniferLopez , New URL840 #Deal #Bargain	NOUN NOUN ADP DET NUM PUNCT NOUN PUNCT ADJ NOUN X X
RT @USER1261 : @USER2115 so was I . Especially because he is literally in the room right next to me and I could hear him laughing whi \u2026	X X PUNCT NOUN ADV AUX PRON PUNCT NOUN SCONJ PRON AUX ADV ADP DET NOUN ADV ADJ ADP PRON CCONJ PRON AUX VERB PRON VERB NOUN PUNCT
\ He , once again , ripped strands of his hair out and ran to his lair . Preparing for a wonderful barrage . A barrage of excellence . \	PUNCT PRON PUNCT ADV ADV PUNCT VERB NOUN ADP PRON NOUN ADV CCONJ VERB ADP PRON NOUN PUNCT NOUN ADP DET ADJ NOUN PUNCT DET NOUN ADP NOUN PUNCT PUNCT
@USER1631 so sad I have to miss it \ud83d\udc94 but we will just do a redo when I get back after all you can never have too many 21st birthdays	PROPN ADV ADJ PRON VERB PART VERB PRON PROPN CCONJ PRON AUX ADV VERB DET NOUN ADV PRON VERB ADV ADP DET PRON AUX ADV VERB ADV ADJ ADJ X
Oh , dear . It 's like the dills who accuse Julan Burnside of making money out of #refugees , do n't bother 2 read . URL1425	INTJ PUNCT NOUN PUNCT PRON AUX ADP DET NOUN PRON NOUN NOUN NOUN ADP VERB NOUN ADP ADP NOUN PUNCT AUX PART VERB NUM VERB PUNCT X
2 people followed me // automatically checked by URL1009	NUM NOUN VERB PRON SYM ADV VERB ADP NOUN
@USER2161 but she been a little distant lately URL1184	NOUN CCONJ PRON AUX DET ADJ NOUN ADV X
@USER840 \ud83d\ude2d I 'll be your buddy	PROPN PROPN PRON AUX AUX PRON NOUN
The Dildo Selfie Stick Exists And We Do n't Know How to Fe ... URL505 URL846	DET NOUN NOUN NOUN NOUN CCONJ PRON AUX PART VERB ADV PART NOUN PUNCT X X
Be you , and be OK with it . It 's the only way you can be truly happy . Be true to yourself . URL718	AUX PRON PUNCT CCONJ AUX ADJ ADP PRON PUNCT PRON AUX DET ADJ NOUN PRON AUX AUX ADV ADJ PUNCT AUX ADJ ADP PRON PUNCT X
RT @USER1879 : Need extra cash for July 4 weekend ?? Come an flip your cash with me starting at $ 150 , Dm me for more info URL224 \u2026	X X PUNCT VERB NOUN NOUN ADP PROPN NUM NOUN PUNCT VERB DET VERB PRON NOUN ADP PRON VERB ADP SYM NOUN PUNCT VERB PRON ADP ADJ NOUN X PUNCT
@USER1112 : PM @USER351 struggles to secure EU Deal . See his policy record and latest activity here URL670	NOUN PUNCT NOUN NOUN NOUN PART NOUN VERB NOUN PUNCT VERB PRON NOUN NOUN CCONJ ADJ NOUN ADV X
o i found one with cloud	PUNCT PRON VERB NUM ADP NOUN
RT @USER1464 : Beautiful Chandelier made of Spoons . URL615	X X PUNCT ADJ NOUN VERB ADP NOUN PUNCT X
RT @USER752 : you want it to stop ? how about you just now hear me out for a second how about how about you JUST GIT FUCKING GUD URL221 \u2026	X X PUNCT PRON VERB PRON PART VERB PUNCT ADV ADP PRON ADV ADV VERB PRON ADP ADP DET ADJ ADV ADP ADV ADP PRON ADV NOUN ADV NOUN X PUNCT
RT @USER1268 : Love this ! \ Casa Dos Chicos hilltop villa - Villas for Rent in Nayarit \ @USER1579 #Travel URL903	X X PUNCT VERB PRON PUNCT PUNCT X X X X X PUNCT NOUN ADP NOUN ADP NOUN PUNCT X X X
RT @USER324 : Ok thread of Chris ' looks cause he lowkey fashionista and ppl sleeping : #ChrisBrown #ICHOOSEBREEZY #backtosleep #Viewer \u2026	X X PUNCT INTJ NOUN ADP PROPN PUNCT VERB SCONJ PRON NOUN NOUN CCONJ NOUN VERB PUNCT X X X X PUNCT
RT @USER1232 : Amen Bishop Father God please help da USA n help us 2 remove our pride n haughty spirits before da fall n Jesus ' Name ht \u2026	X X PUNCT INTJ X PROPN PROPN INTJ VERB DET PROPN CCONJ VERB PRON NUM VERB PRON NOUN CCONJ NOUN NOUN ADP DET VERB CCONJ PROPN PUNCT PROPN X PUNCT
RT @USER1258 : Janitors might as well quit URL1340	X X PUNCT NOUN AUX ADV ADV VERB X
RT @USER2565 : Glencoe Lochan by Alan Howe Photography on Flickr ( cc ) #Scotland #photography #forest URL270	X X PUNCT X NOUN ADP PROPN X NOUN ADP NOUN PUNCT NOUN PUNCT X X X X
RT @USER524 : Grey 's Anatomy season 13 is expected to premiere on September 22 . RT to save a life .	X X PUNCT NOUN PART NOUN NOUN NUM AUX NOUN ADP ADJ ADP NOUN NOUN PUNCT VERB PART VERB DET NOUN PUNCT
@USER1107 @USER2064 see the unnecessary fear by an MD . So cruel . URL731	NOUN NOUN VERB DET NOUN NOUN ADP DET NOUN PUNCT ADV NOUN PUNCT X
@USER1710 Glad to see I was n't the only one to think of that ! \ No networks ! \	PROPN ADJ PART VERB PRON AUX PART DET ADJ NOUN PART VERB ADP PRON PUNCT PUNCT DET NOUN PUNCT PUNCT
Really trying to get rid of these lmk if you interested !! URL319	ADV VERB PART VERB VERB ADP DET NOUN SCONJ PRON VERB PUNCT X
RT @USER2352 : @USER1947 WHY YOU DO THAT TO ME ? I BEEN WRITING ONE HUNDRED TEN TWEET WITH THE SAME QUESTION AND YOU JUST IGNORE M \u2026	X X PUNCT NOUN ADV PRON VERB PRON ADP PRON PUNCT PRON VERB X X X X VERB ADP DET NOUN NOUN CCONJ PRON ADV NOUN X PUNCT
The latest The Claudio Russo Daily ! URL970 Thanks to @USER365 @USER2218 #brexit #technology	DET ADJ DET NOUN NOUN NOUN PUNCT X NOUN ADP X X X X
RT @USER380 : \ The Largest Swimming Pool in the World Found at URL606 URL1043 \	X X PUNCT PUNCT DET NOUN NOUN NOUN ADP DET NOUN NOUN ADP NOUN NOUN PUNCT
RT @USER860 : Season 6 is coming soon . #TeenWolf URL1569	X X PUNCT NOUN NUM AUX VERB ADV PUNCT X X
RT @USER2082 : I need to see #FindingDory	X X PUNCT PRON VERB PART VERB X
RT @USER2533 : Rihanna made this a hit , obviously . \ So live ya life , ayeeeeee \ \ud83d\ude1b URL800	X X PUNCT PROPN VERB DET DET NOUN PUNCT ADV PUNCT PUNCT ADV VERB PRON NOUN PUNCT PROPN PUNCT X X
RT @USER260 : The Greatest Boyfriend Ever Proposed At A @USER199 Meet And Greet URL971 via @USER1711 htt \u2026	X X PUNCT DET NOUN NOUN ADV NOUN ADP DET NOUN NOUN CCONJ NOUN NOUN ADP X X PUNCT
RT @USER1664 : Got ta respect Laremy Tunsil tweeting out how strong his lungs are 10 minutes before he gets drafted URL1101 \u2026	X X PUNCT VERB PART NOUN NOUN NOUN VERB ADP ADV ADJ PRON NOUN AUX NUM NOUN SCONJ PRON VERB NOUN X PUNCT
@USER723 act u prob right bc my trip next year is gon na cost like 10 k	NOUN VERB PRON VERB ADV VERB PRON NOUN ADJ NOUN AUX VERB PART NOUN ADP NUM NUM
\u26a1\ufe0f \u201c Michelle Obama brought down the DNC house \u201d URL864	NOUN PUNCT NOUN PROPN NOUN ADP DET PROPN NOUN PUNCT X
RT @USER1692 : @USER1674 I was thinking the same thing	X X PUNCT X PRON AUX VERB DET ADJ NOUN
Amazon Kindle 3 keyboard . D00901 . Never Used Still In Plastic - Bid Now ! Only $ 27.01 URL676 URL555	PROPN NOUN NUM NOUN PUNCT NOUN PUNCT ADV NOUN ADV ADP NOUN PUNCT VERB ADV PUNCT ADV SYM X X X
RT @USER1415 : I 'd talk about how ZTD came out or how Sigma 's one can be folded up . [ Sat July 2 3:45 pm - 4:45 pm ] [ Place : 408 AB ] I hope \u2026	X X PUNCT PRON AUX VERB ADP ADV NOUN VERB ADV CCONJ ADV NOUN PART NUM AUX AUX VERB ADP PUNCT PUNCT NUM PROPN NUM NOUN NOUN PUNCT X NOUN PUNCT PUNCT X PUNCT X X PUNCT PRON VERB PUNCT
Book release news , and enter to win a $ 25 Amazon gift card ! URL442 #ya #scifi #mystery	NOUN VERB NOUN PUNCT CCONJ VERB PART VERB DET SYM NUM PROPN NOUN NOUN PUNCT X X X X
Eagles of Death Metal return : ' Much more than a show ' URL732 URL480	PROPN ADP NOUN NOUN NOUN PUNCT PUNCT ADV ADJ ADP DET NOUN PUNCT X X
San Miguel , Telstra talks break down URL667	PROPN NOUN PUNCT NOUN VERB NOUN ADV X
#Jesus is not a part time Lord . Amen	PROPN AUX PART DET NOUN NOUN NOUN PUNCT SYM
Today is the last day I ask my boyfriend to do any prep work for dinner . Boy do n't know how to season anything	NOUN AUX DET ADJ NOUN PRON VERB PRON NOUN PART VERB DET NOUN NOUN ADP NOUN PUNCT NOUN AUX PART VERB ADV PART NOUN PRON
RT @USER707 : Take some time today and thank God for sending his Son Jesus so that our sins could be forgiven and we can be free . #goodfr \u2026	X X PUNCT VERB DET NOUN NOUN CCONJ VERB PROPN ADP PROPN PRON NOUN PROPN ADV SCONJ PRON NOUN AUX AUX NOUN CCONJ PRON AUX AUX ADJ PUNCT X PUNCT
RT @USER1786 : Arheologist prof. Diana Gergova shows newly discovered mystical ... #velingrad URL1635	X X PUNCT X X X X NOUN X X X PUNCT X X
RT @USER1596 : SLIM THICK W YO CUTE AH @USER1528 URL579	X X PUNCT X X PROPN PRON ADJ X X X
RT @USER186 : These Failed Tattoos Are Just Absolutely Hilarious \u2026 It Will Make You Cry with Laughter URL328 URL223 \u2026	X X PUNCT DET ADJ NOUN AUX ADV NOUN NOUN PUNCT PRON AUX VERB PRON VERB ADP NOUN X X PUNCT
RT @USER950 : I 'm a failure . Allah is my forgiver . I 'm a sinner . Allah is my savior . I 'm broken . Allah is healer .	X X PUNCT PRON AUX DET NOUN PUNCT PROPN AUX PRON NOUN PUNCT PRON AUX DET NOUN PUNCT PROPN AUX PRON NOUN PUNCT PRON AUX ADJ PUNCT PROPN AUX NOUN PUNCT
Great thanks to @USER2580 for allowing me to announce a great night of fights at the @USER1942 . Hope to be back soon .	ADJ NOUN PART NOUN ADP VERB PRON PART VERB DET ADJ NOUN ADP NOUN ADP DET NOUN PUNCT VERB PART AUX ADV ADV PUNCT
RT @USER262 : #JESUS Said , Before Abraham Was , \ I AM ! \ In John 's Gospel , Jesus said , \ I AM \ 7 Different Times . Ch. 6 , 8 , 10 , 11 , 15 URL218 \u2026	X X PUNCT NOUN NOUN PUNCT ADV NOUN ADV PUNCT PUNCT PRON NOUN PUNCT PUNCT ADP PROPN PART PROPN PUNCT PROPN VERB PUNCT PUNCT PRON NOUN PUNCT NUM ADJ NOUN PUNCT NOUN NUM PUNCT NUM PUNCT NUM PUNCT NUM PUNCT NUM X PUNCT
He 'll always come back home cause I 'm his backbone \ud83d\ude0f	PRON AUX ADV VERB ADV ADV SCONJ PRON AUX PRON NOUN X
Seven hours of video show changes in accused Tochigi killer 's demeanor URL691	NOUN NOUN ADP NOUN NOUN VERB ADP PROPN X X PART X X
@USER1568 lol where Uu wan na go Pee ? \ud83d\ude02\ud83d\ude02	PROPN INTJ ADV VERB VERB PART VERB NOUN PUNCT SYM
Dealing With Erectile Dysfunction URL892	NOUN ADP NOUN NOUN X
@USER755 let 's fuckin go	NOUN VERB PART NOUN VERB
@USER1264 \ WHERE !? \ Quickly looks around for the Pichu . \ WHERE IS IT !? \	NOUN PUNCT NOUN PUNCT PUNCT NOUN VERB ADP ADP DET NOUN PUNCT PUNCT NOUN AUX PRON PUNCT PUNCT
Not looking forward to going back to work tomorrow	PART VERB ADV PART VERB ADV ADP VERB NOUN
RT @USER1344 : Ordering Wine at a Restaurant : The Cheat Sheet URL1277 #wine #winelovers #food URL1136	X X PUNCT ADJ NOUN ADP DET NOUN PUNCT DET PROPN NOUN X X X X X
RT @USER1138 : \ You say you want a Revolution ... \ Hell yeah !!! #Beatles #FeelTheBern #NYPrimary URL624	X X PUNCT PUNCT PRON VERB PRON VERB DET NOUN PUNCT PUNCT PROPN INTJ PUNCT X X X X
@USER23 break the plans we had before let 's be unpredictable	NOUN VERB DET NOUN PRON VERB SCONJ VERB PART AUX ADJ
RT @USER1360 : she 'll show you the world through her eyes URL741	X X PUNCT PRON AUX VERB PRON DET NOUN ADP PRON NOUN X
The Initial step For Internet marketing Success URL1553	DET NOUN NOUN ADP NOUN NOUN NOUN X
RT @USER692 : We can live with the confidence that all of our sins have been washed away . That \u2019s the power of the blood .	X X PUNCT PRON AUX VERB ADP DET NOUN PRON DET ADP PRON NOUN AUX AUX VERB ADV PUNCT PRON VERB DET NOUN ADP DET NOUN PUNCT
Getting ready ... @ Pasco Ephesus Seventh - day Adventist Church URL823	VERB ADJ PUNCT ADP PROPN X X PUNCT NOUN X X X
RT @USER1823 : rebecca mader is so hot .	X X PUNCT NOUN NOUN AUX ADV ADJ PUNCT
RT @USER466 : How modern day learning is evolving thanks to new tech : URL362 #edtech #onlinelearning #elearning URL220 \u2026	X X PUNCT ADV NOUN NOUN NOUN AUX NOUN NOUN ADP ADJ NOUN PUNCT X X X X X PUNCT
RT @USER2367 : If I do n't fwy and your bringing up my name bitch you are BOTHERED and ima keep it real \ud83d\ude02\ud83d\ude02\ud83d\udcaf	X X PUNCT SCONJ PRON AUX PART VERB CCONJ PRON VERB ADP PRON NOUN NOUN PRON AUX NOUN CCONJ VERB VERB PRON ADJ X
The Fight Between Bernie Sanders And Hillary Clinton Is Officially Super Ugly . Very good read . URL1141	DET NOUN NOUN NOUN PROPN CCONJ PROPN PROPN AUX NOUN NOUN ADJ PUNCT ADJ ADJ NOUN PUNCT X
No emergency budget , no activating article 50 , no plan - if this was #Labour in govt #Murdoch & the rest would be fomenting a #coup	DET NOUN NOUN PUNCT DET NOUN NOUN NUM PUNCT DET NOUN PUNCT SCONJ PRON AUX NOUN ADP NOUN NOUN CCONJ DET NOUN AUX AUX VERB DET NOUN
RT @USER1238 : Showing your appreciation of sunshine by sitting outside , tilting your head back , closing your eyes and pretending to be \u2026	X X PUNCT VERB PRON NOUN ADP NOUN ADP VERB ADV PUNCT VERB PRON NOUN ADV PUNCT VERB PRON NOUN CCONJ VERB PART AUX PUNCT
God why these kind of people are still exist . They annoyed me so much . I swear . \ud83d\ude43\u270b\ud83c\udffc\ud83d\ude42	PROPN ADV DET NOUN ADP NOUN AUX ADV ADV PUNCT PRON VERB PRON ADV ADV PUNCT PRON VERB PUNCT X
#SouthBelfast : traffic busy Saintfield Road from Rosetta towards Annadale Avenue / Forestside countrybound	NOUN PUNCT NOUN ADJ NOUN NOUN ADP PROPN X X X PUNCT X X
Ecigs are the febreze for leesville bathrooms \ud83d\ude44	NOUN AUX DET NOUN ADP NOUN X X
RT @USER449 : Any liberal who thinks AR stands for assault rifle and not Armalite , should probably STFU about guns #filibuster	X X PUNCT DET NOUN PRON VERB NOUN NOUN ADP NOUN NOUN CCONJ PART NOUN PUNCT AUX ADV VERB ADP NOUN X
@USER114 no but really bo1 tournaments would get so many teams it would be so much fun	NOUN DET CCONJ ADV NOUN NOUN AUX VERB ADV ADJ NOUN PRON AUX AUX ADV ADV NOUN
Join the Speedway team ! See our latest #CustomerService #job opening here : URL1194 #Greendale , WI #Hiring #CareerArc	VERB DET NOUN NOUN PUNCT VERB PRON ADJ NOUN X NOUN ADV PUNCT X X PUNCT X X X
blessed URL488	PRON NOUN
RT @USER2656 : A silly dragonhardt comic before bed . #overwatch URL878	X X PUNCT DET ADJ NOUN NOUN ADP NOUN PUNCT X X
@USER591 @USER1682 ima be rude but not enough fingies to operate it	PROPN NOUN VERB AUX NOUN CCONJ PART ADJ NOUN PART VERB PRON
RT @USER2468 : Other hairstylist : EXO is doing so well on the charts ! Me : yeah , so happy for them O.H : is EXO famous outside of Korea ? Me : ye \u2026	X X PUNCT X X PUNCT NOUN AUX VERB ADV ADV ADP DET NOUN PUNCT PRON PUNCT INTJ PUNCT ADV ADJ ADP PRON NOUN PUNCT AUX NOUN ADJ ADJ ADP NOUN PUNCT PRON PUNCT PRON PUNCT
Some terrific #Leadership lessons from a proven #leader . URL323	DET NOUN NOUN NOUN ADP DET ADJ NOUN PUNCT X
@USER1681 I promise I will never unfollow you !! \u2764\ufe0f\ud83d\ude0d	PROPN PRON VERB PRON AUX ADV VERB PRON PUNCT X
RT @USER733 : My KC Scout Traffic Alert Cleared : Roadwork on I-470 WB ( East / West ) PAST DOUGLAS ST Message #8252-14783	X X PUNCT PRON NOUN NOUN NOUN X X PUNCT NOUN ADP NOUN NOUN PUNCT PROPN PUNCT NOUN PUNCT X X X X X
i be soo bored at home \ud83d\ude44 i need to get that application asap \ud83d\ude2c\ud83d\udcaf	PRON AUX NOUN ADJ ADP ADV PROPN PRON VERB PART VERB PRON NOUN NOUN X
@USER1878 @USER344 you really deserve it	PROPN PROPN PRON ADV VERB PRON
@USER1455 So you want my number .... That 's romantic AF !!! hahahha .... You should be polite AF when asking things like that !!! hahahha	PROPN ADV PRON VERB PRON NOUN PUNCT PRON AUX NOUN NOUN PUNCT X PUNCT PRON AUX AUX NOUN NOUN ADV VERB NOUN ADP PRON PUNCT X
@USER193 14 exactly	NOUN NUM ADV
I 'm waiting for it URL514	PRON AUX VERB ADP PRON NOUN
@USER1567 this is the funniest thing but the shirt gave me good luck so i dunno if ure gon na get that back buddy	VERB PRON AUX DET ADJ NOUN CCONJ DET NOUN VERB PRON ADJ NOUN ADV PRON VERB SCONJ NOUN VERB PART VERB PRON ADV NOUN
RT @USER806 : This Dog 's Face Was Eaten By Maggots , See The Transformation Now URL1158	X X PUNCT DET NOUN PART NOUN ADV NOUN ADP NOUN PUNCT VERB DET NOUN ADV X
@USER1420 was n't sure if you posted about this , the Frisco Roughriders are wearing gaming themed unis on July 8th . URL1214	NOUN AUX PART ADJ SCONJ PRON VERB ADP PRON PUNCT DET NOUN NOUN AUX VERB NOUN X X ADP PROPN NOUN PUNCT X
RT @USER2363 : \ud83d\udc3a LITTLE TEETH RETURNS 3/4 \ud83d\udc39 written by @USER1900 art by me ! ty @USER551 @USER2459 URL944 URL219 \u2026	X X PUNCT X X X X X X VERB ADP NOUN NOUN ADP PRON PUNCT X X X X X PUNCT
@USER803 \ If it 's with you then I do n't mind - \	NOUN PUNCT SCONJ PRON AUX ADP PRON ADV PRON AUX PART NOUN PUNCT PUNCT
Try this Easy Chicken Cordon Bleu #recipe using @USER1049 . #PerdueCrew #promotion - URL647 URL249	VERB PRON ADJ NOUN NOUN X NOUN VERB NOUN PUNCT X X PUNCT X X
RT @USER59 : Aisle marking tape Archives | URL1187	X X PUNCT X X NOUN X SYM X
RT @USER282 : Remember when you lay your head down at night that life is precious . And if you 're blessed enough to wake up again remind \u2026	X X PUNCT NOUN ADV PRON VERB PRON NOUN ADV ADP NOUN DET NOUN AUX NOUN PUNCT CCONJ SCONJ PRON AUX VERB ADJ PART VERB ADP ADV VERB PUNCT
that \ what 'd I do ? look at her ! \ by Stecklein , lol	PRON PUNCT PRON AUX PRON VERB PUNCT VERB ADP PRON PUNCT PUNCT ADP PROPN PUNCT INTJ
RT @USER930 : I started something , I forced you into a zone and you were clearly never meant to go .	X X PUNCT PRON VERB PRON PUNCT PRON VERB PRON ADP DET NOUN CCONJ PRON AUX NOUN ADV VERB PART VERB PUNCT
RT @USER1929 : Philosophy - Cambridge University | Psychology & Social ... URL1164 #psychologysocialscience	X X PUNCT NOUN PUNCT NOUN PROPN SYM NOUN CCONJ ADJ PUNCT X X
RT @USER18 : Will D #French #Senate demand FM #Zarif 2end persecution of Christians in #Iran ? #directsenat #no2rouhani #FreeIran URL0 \u2026	X X PUNCT AUX PROPN NOUN NOUN VERB NOUN NOUN X NOUN ADP NOUN ADP X PUNCT X X X X PUNCT
Going to Dj Friday 's parties is just girls excuse to dress up & look cute , do n't even enjoy them anymore	VERB ADP PROPN PROPN PART NOUN AUX ADV NOUN NOUN PART VERB ADP CCONJ VERB ADJ PUNCT AUX PART ADV VERB PRON ADV
RT @USER764 : Does it count as drinking alone if you 're watching the series finale of Buffy ( again ) , you 're folding laundry and your cat is \u2026	X X PUNCT VERB PRON VERB SCONJ NOUN ADV SCONJ PRON AUX VERB DET NOUN NOUN ADP NOUN PUNCT ADV PUNCT PUNCT PRON AUX NOUN NOUN CCONJ PRON NOUN AUX PUNCT
I miss the feeling of you missing me	PRON VERB DET NOUN ADP PRON VERB PRON
RT @USER1998 : joshua almost cried so vernon rubbed his back to calm him down omg i find this so so cute URL1072	X X PUNCT NOUN ADV NOUN ADV NOUN VERB PRON ADV PART ADJ PRON ADV INTJ PRON VERB PRON ADV ADV ADJ X
go to bet ?? \u2661	VERB PART VERB PUNCT SYM
School is so stressful	NOUN AUX ADV NOUN
OneRepublic - Counting Stars URL681 via @USER1490	NOUN PUNCT NOUN NOUN NOUN ADP PROPN
These mfs got me fucked up if they think they bouts give me another blood transfusion	DET NOUN VERB PRON VERB ADP SCONJ PRON VERB PRON VERB VERB PRON DET NOUN X
@USER1449 He knows the game as well as anybody . That 's always been true .	PROPN PRON VERB DET NOUN ADP ADV ADP NOUN PUNCT PRON AUX ADV AUX ADJ PUNCT
\ud83d\ude02 shame he 's a professional wankster URL506	SYM NOUN PRON AUX DET ADJ NOUN X
really cool ! URL1011	ADV ADJ PUNCT X
The best is the enemy of good . - Voltaire #quote #winwithjohn	DET ADJ AUX DET NOUN ADP ADJ PUNCT PUNCT X X X
RT @USER891 : @USER2114 well , I happen to be a pro PJ , did n't you know ? I learned 4 songs , more or less . I know , pretty impressive .	X X PUNCT NOUN INTJ PUNCT PRON VERB PART AUX DET NOUN NOUN PUNCT AUX PART PRON VERB PUNCT PRON VERB NUM NOUN PUNCT ADJ CCONJ ADJ PUNCT PRON VERB PUNCT ADV NOUN PUNCT
RT @USER1158 : Sidney Crosby joins Joe Sakic as only players in history with Olympic Gold World Jr. Gold World Champ Stanley Cup Hart Troph \u2026	X X PUNCT X X X X NOUN ADP ADV NOUN ADP NOUN ADP NOUN NOUN PROPN PROPN PROPN PROPN NOUN X X X X PUNCT
RT @USER2466 : Quick subs of SNSD cut on today 's Slam Dunk episode ^^ [ ENG SUB ] SNSD CUT - KBS SISTER 'S SLAM DUNK EP7 URL452 \u2026	X X PUNCT ADJ NOUN ADP PROPN VERB ADP NOUN PART NOUN X NOUN X PUNCT X X PUNCT PROPN X PUNCT X X PART NOUN X X X PUNCT
RT @USER64 : I hate when ppl says \ nak tanya ni \ but suddenly \ em tade pape la \ . Lol I 'm freaking curious abt what they want to ask me .	X X PUNCT PRON VERB ADV NOUN VERB PUNCT X X X PUNCT CCONJ NOUN PUNCT PRON NOUN X X PUNCT PUNCT INTJ PRON AUX VERB ADJ ADP PRON PRON VERB PART VERB PRON PUNCT
Two cars hit and we are n't even drunk yet \ud83d\ude02 @USER1658 @USER1394 .	NUM NOUN VERB CCONJ PRON AUX PART ADV NOUN ADV SYM X X PUNCT
Pablo Sandoval religiously followed the El Guapo diet and exercise plan during the offseason .	NOUN NOUN NOUN VERB DET PROPN NOUN NOUN CCONJ NOUN NOUN ADP DET NOUN PUNCT
RT @USER453 : Childhood Fantasy Destroyed By The Sinister Origins Of These 15 Disney Movies ! URL683 URL1272 \u2026	X X PUNCT X X X ADP DET NOUN NOUN ADP ADJ NUM PROPN NOUN PUNCT X X PUNCT
RT @USER2012 : How is he so effortlessly beautiful ? These are candid ? He is so soft ? URL959	X X PUNCT ADV AUX PRON ADV NOUN ADJ PUNCT DET AUX NOUN PUNCT PRON AUX ADV NOUN PUNCT X
RT @USER290 : Printable Zentangle Colouring Page Seahorse by thecrayonkitchen URL1349 #etsymntt #ESkids #craftbuzz #ep \u2026	X X PUNCT ADJ NOUN X X X ADP PROPN X X X X X PUNCT
Congratulations to @USER1154 for winning #SJA #MedicalFirstResponders #Ontario #Championship . #LdnOnt URL1071	NOUN PART NOUN ADP VERB NOUN X X X PUNCT X X
Oil and Gas ETFs Update . Select Oil and Gas ETFs at URL1282 or visit URL413	NOUN CCONJ NOUN NOUN NOUN PUNCT NOUN NOUN CCONJ NOUN NOUN ADP NOUN CCONJ NOUN X
RT @USER2449 : Limited Pre-Order : Kim Jae Joong NO.X Hologram Seoul Concert Official Goods worldwide shipping more details pls DM >> ht \u2026	X X PUNCT X X PUNCT PROPN X X X X X PROPN PROPN NOUN ADV NOUN ADJ NOUN INTJ X PUNCT X PUNCT
I Ai n't had sex in while had dream lil vagina 's was chasing me	PRON NOUN PART VERB NOUN ADP SCONJ VERB NOUN ADJ NOUN PART AUX VERB PRON
RT @USER2295 : Church is designed to be a community of friends , where people are not judged , but loved , accepted and welcomed home .	X X PUNCT NOUN AUX NOUN PART AUX DET NOUN ADP NOUN PUNCT ADV NOUN AUX PART NOUN PUNCT CCONJ VERB PUNCT VERB CCONJ NOUN ADV PUNCT
RT @USER1206 : The * ALL NEW * URL233 will be available to all customers at 10:45 pm PST \ud83d\ude05\ud83d\ude4c\ud83c\udffd ! Shop with us TONIGHT \ud83d\udd25 ht \u2026	X X PUNCT DET PUNCT DET ADJ PUNCT NOUN AUX AUX ADJ ADP DET NOUN ADP PROPN NOUN PROPN NOUN PUNCT PROPN ADP PRON NOUN X X PUNCT
Most of supercells music makes me emotional	ADJ ADP NOUN NOUN VERB PRON ADJ
RT @USER2293 : Yall never forget this beautiful legendary moment URL1537	X X PUNCT PRON ADV VERB PRON ADJ NOUN NOUN X
@USER2639 catching all passes . Might throw some spirals	NOUN VERB DET NOUN PUNCT X VERB DET NOUN
RT @USER1533 : Hell yeah ... Same URL1398	X X PUNCT NOUN INTJ PUNCT ADJ NOUN
RT @USER1288 : \ Life After Winning The Power Ball \ URL1232	X X PUNCT PUNCT NOUN ADP NOUN DET NOUN NOUN PUNCT X
RT @USER823 : The face @USER1569 makes when he rolls a gutter ball \ud83d\ude02\ud83c\udfb3 URL1245	X X PUNCT DET NOUN NOUN VERB ADV PRON VERB DET NOUN NOUN X X
RT @USER2156 : Only a few days left ... :) @USER1793 @USER1726 Photo vs Drawing : I try to work precise :) URL489	X X PUNCT ADV DET ADJ NOUN ADJ PUNCT SYM X X NOUN PROPN NOUN PUNCT PRON VERB PART VERB ADJ SYM X
RT @USER1283 : { Preview } 160404 Qianxi @ OPPO R9 CF #Shooting Cr. as tagged URL710	X X PUNCT X X X X X ADP X X X X X ADP NOUN X
RT @USER1372 : Follow & retweet for the love of #prettyporn~ So close to reaching 6 k followers ! URL784	X X PUNCT VERB CCONJ VERB ADP DET NOUN ADP NOUN ADV ADJ ADP NOUN NUM NUM NOUN PUNCT X
OMG I have hope :')	INTJ PRON VERB VERB SYM
My Twitter is worth $ 24,120.00 today . Find Out Your Vanity Twitter Value Free - Click Here ==> URL342 #freefollowers	PRON PROPN AUX NOUN SYM NOUN NOUN PUNCT VERB ADP PRON NOUN PROPN X ADJ PUNCT NOUN ADV X X X
\ Storm Surf \ Tee inspires us all that no matter what the conditions , being in the water is where \u2026 URL1230	PUNCT NOUN NOUN PUNCT NOUN VERB PRON DET PRON DET VERB PRON DET NOUN PUNCT AUX ADP DET NOUN AUX ADV PUNCT X
@USER429 Hey Michelle what 's going on ? #StateOfWomen	PROPN INTJ VERB PRON AUX VERB ADP PUNCT X
RT @USER518 : So proud of how hard @USER770 have worked to keep #hellomynameis alive in the organisation ... URL1088	X X PUNCT ADV ADJ ADP ADV ADJ NOUN AUX VERB PART VERB NOUN NOUN ADP DET NOUN PUNCT X
RT @USER17 : Just because I 'm on Twitter does n't mean I 'm taking texts right now .	X X PUNCT ADV SCONJ PRON AUX ADP PROPN AUX PART VERB PRON AUX VERB ADJ ADV ADV PUNCT
RT @USER1913 : you really need both type of friends URL1060	X X PUNCT PRON ADV VERB DET NOUN ADP NOUN X
RT @USER1735 : She is art . You do n't have to understand her . She was n't built to validate your opinion . Accept her for the beautiful ambiguit \u2026	X X PUNCT PRON AUX NOUN PUNCT PRON AUX PART VERB PART VERB PRON PUNCT PRON AUX PART VERB PART VERB PRON NOUN PUNCT VERB PRON ADP DET ADJ NOUN PUNCT
@USER1729 @USER673 serious question : what 's the deal with the turtle comments ?	NOUN NOUN ADJ NOUN PUNCT PRON AUX DET NOUN ADP DET NOUN NOUN PUNCT
@USER901 @USER1093 Lmao welp . We know he 's either a virgin or he sucks in bed	PROPN PROPN INTJ NOUN PUNCT PRON VERB PRON AUX VERB DET NOUN CCONJ PRON ADV ADP NOUN
* CAUTION * if you 've received snaps like these from @USER2446 , you 're not special , you have been mass snapped URL1077	PUNCT NOUN PUNCT SCONJ PRON AUX NOUN NOUN ADP DET ADP NOUN PUNCT PRON AUX PART ADJ PUNCT PRON AUX AUX ADJ X X
@USER2378 trump i do nt like the sound of that	PROPN PROPN PRON AUX PART VERB DET NOUN ADP PRON
RT @USER463 : Close Enough ! URL660	X X PUNCT NOUN ADJ PUNCT X
How much Faith does the Pope have ?	ADV ADV NOUN AUX DET NOUN VERB PUNCT
RT @USER1062 : \u201c Whatever you do , never run back to what broke you . \u201d	X X PUNCT PUNCT NOUN PRON VERB PUNCT ADV VERB ADV ADP PRON VERB PRON PUNCT PUNCT
Probably the duff	ADV DET NOUN
As soon as I did lightning stuck really dang close	ADV ADV SCONJ PRON AUX NOUN VERB ADV ADJ ADJ
@USER2131 ( if my mom lets but she probably will though lmao )	NOUN PUNCT SCONJ PRON NOUN VERB CCONJ PRON ADV AUX ADV INTJ PUNCT
either 1 bc black af or 4 bc gay and hot af URL876	ADV NUM NOUN ADJ NOUN CCONJ NUM NOUN ADJ CCONJ ADJ NOUN X
THE HERSHEY 'S WORLD WILL BE THE DEATH OF ME	DET NOUN PART NOUN AUX AUX DET NOUN ADP PRON
RT @USER748 : Ca n't stop a nigga when you know he on a mission	X X PUNCT AUX PART VERB DET NOUN ADV PRON VERB PRON ADP DET NOUN
RT @USER635 : can u name them ? #ALDUBGetThemLolaTini URL1097	X X PUNCT AUX PRON VERB PRON PUNCT X X
RT @USER1282 : Lots of hate towards K-Pop fans right now . If you want your favs to win then vote hard like them . No need for racist comme \u2026	X X PUNCT NOUN ADP VERB NOUN PROPN NOUN ADV ADV PUNCT SCONJ PRON VERB PRON NOUN PART VERB ADV VERB ADJ ADP PRON PUNCT DET VERB ADP ADJ NOUN PUNCT
RT @USER1928 : @USER530 #FindGodWithin Happy Propose day Guru ji URL1078	X X PUNCT X NOUN ADJ NOUN NOUN X X X
RT @USER2232 : I know I will never be everyones 's cup of tea but I would like to be someone 's custom made drink .	X X PUNCT PRON VERB PRON AUX ADV AUX NOUN PART NOUN ADP NOUN CCONJ PRON AUX VERB PART AUX PRON PART NOUN VERB NOUN PUNCT
I wan na hear you myself . Forget the TL . URL466	PRON VERB PART VERB PRON PRON PUNCT VERB DET PROPN PUNCT X
RT @USER289 : Never forget . The whole of a religious group should n't be judged by the extreme actions of a few within their ranks . URL219 \u2026	X X PUNCT ADV VERB PUNCT DET ADJ ADP DET NOUN NOUN AUX PART AUX VERB ADP DET ADJ NOUN ADP DET ADJ ADP PRON NOUN PUNCT X PUNCT
RT @USER1781 : Me : * is dead * Louis and Harry : plays rock paper scissors , Harry touches Louis ' hand Me : URL721	X X PUNCT PRON PUNCT PUNCT AUX ADJ PUNCT PROPN CCONJ PROPN PUNCT VERB NOUN NOUN NOUN PUNCT PROPN NOUN PROPN PUNCT NOUN PRON PUNCT X
@USER2068 I think your all just mad now because I spilled the truth on it .. Devan always seems to get left overs with who he 's with \ud83c\udf1a	PROPN PRON VERB PRON DET ADV ADJ ADV SCONJ PRON VERB DET NOUN ADP PRON PUNCT NOUN ADV VERB PART VERB ADJ NOUN ADP PRON PRON AUX ADP SYM
RT @USER1085 : I cant believe yall never been to this part of Omaha \ud83e\udd14 URL1163	X X PUNCT PRON AUX VERB PRON ADV AUX ADP DET NOUN ADP NOUN SYM X
@USER1741 Ok but Hannigan is a JAG . Leon has some energy , decent arm and surprising bat .	PROPN INTJ CCONJ NOUN AUX DET NOUN PUNCT NOUN VERB DET NOUN PUNCT NOUN NOUN CCONJ NOUN NOUN PUNCT
RT @USER2593 : mi abuela Maria so annoying smh URL1069	X X PUNCT X PROPN PROPN ADV ADJ INTJ X
RT @USER1858 : It 's all starting !!!!! @USER1076 @USER46 @USER1029 #blessed first table Read ! URL1557	X X PUNCT PRON AUX DET NOUN PUNCT X X X X ADJ NOUN NOUN PUNCT X
DDO woman living with mould / collapsed ceiling after flooding Feb 15 in vacant unit above . Condo assoc. denying resp. URL902	NOUN NOUN VERB ADP NOUN PUNCT NOUN NOUN ADP NOUN NOUN NUM ADP NOUN NOUN ADP PUNCT X X X X X
@USER519 @USER1903 This deserves many favorites .	PROPN VERB PRON VERB ADJ NOUN PUNCT
RT @USER1546 : If this is n't me then what is URL1414	X X PUNCT SCONJ PRON AUX PART PRON ADV PRON AUX X
I will do what you want on my cam . URL411 #threesome #bootylicious #sexdating #pussyfuck URL616	PRON AUX VERB PRON PRON VERB ADP PRON NOUN PUNCT X X X X X X
When 's it going to be my turn to have a cute relationship with someone who actually cares for me ://	ADV AUX PRON VERB PART AUX PRON NOUN PART VERB DET ADJ NOUN ADP PRON PRON ADV VERB ADP PRON SYM
I 'm ALIVE ! Fucking cold you can go to hell ...	PRON AUX NOUN PUNCT VERB NOUN PRON AUX VERB ADP NOUN PUNCT
RT @USER433 : Most laugh tracks for TV were recorded in the 1950s , which means many of the people you hear laughing are dead .	X X PUNCT ADJ NOUN NOUN ADP NOUN AUX NOUN ADP DET NOUN PUNCT PRON VERB ADJ ADP DET NOUN PRON VERB NOUN AUX ADJ PUNCT
RT @USER2233 : Gun violence causes 30,000 deaths a year , but some refuse to call it a legitimate public health issue #yourmiccheck URL612 \u2026	X X PUNCT NOUN NOUN NOUN ADP NOUN DET NOUN PUNCT CCONJ DET NOUN PART VERB PRON DET ADJ NOUN NOUN NOUN NOUN X PUNCT
Ii Guess Ii Wo n't Be Getting What Ii Want Tonight ..	PROPN VERB NOUN NOUN PART AUX VERB PRON NOUN VERB NOUN PUNCT
RT @USER1599 : 1D stans starter pack URL306	X X PUNCT X X X NOUN X
RT @USER1001 : 6 ) WITH YOU WAS MY FUCKING JAM URL1361	X X PUNCT NUM PUNCT ADP PRON AUX PRON ADJ NOUN X
RT @USER1153 : do you ever just look at yourself in snapchat front camera and just stare and that s it URL1103	X X PUNCT VERB PRON ADV ADV VERB ADP PRON ADP PROPN NOUN NOUN CCONJ ADV NOUN CCONJ PRON AUX PRON X
RT @USER654 : Former Bush Treas Sec ( & China hand ) Hank Paulson sets example that should shame the Vichy Republicans URL1146 \u2026	X X PUNCT PROPN PROPN NOUN NOUN PUNCT CCONJ PROPN NOUN PUNCT X X X X PRON AUX VERB DET NOUN X X PUNCT
RT @USER501 : beach party with @USER450 and @USER1886 looks fun af \u2600\ufe0f \ud83c\udf34 #AIMHvideo URL457 URL1365	X X PUNCT NOUN NOUN ADP PROPN CCONJ NOUN VERB NOUN NOUN X X X X X
RT @USER1391 : Now Northern Ireland and Polish fans are fighting in Nice ! URL1472	X X PUNCT ADV NOUN NOUN CCONJ ADJ NOUN AUX VERB ADP ADJ PUNCT X
RT @USER1131 : Wait omg I had no clue people were WATCHING \ud83d\udc40 URL1225	X X PUNCT VERB INTJ PRON VERB DET NOUN NOUN AUX X X X
RT @USER2058 : Hashtag national have an excuse to get drunk off wine day	X X PUNCT NOUN NOUN VERB DET NOUN PART VERB NOUN ADP NOUN NOUN
@USER1311 if I had one of these I would go back to 2008 and never connect with u guys URL629	NOUN SCONJ PRON VERB NUM ADP DET PRON AUX VERB ADV ADP NOUN CCONJ ADV VERB ADP PRON NOUN X
@USER1132 Gon na have to buy a Rico Riders t shirt soon ..	PROPN VERB PART VERB PART VERB DET NOUN NOUN PART NOUN ADV PUNCT
You know times are hard when even Batman is having a go at you .. URL1336	PRON VERB NOUN AUX ADJ ADV ADV NOUN AUX VERB DET VERB ADP PRON PUNCT X
New day , new tweets , new stats . 1 new unfollower . Via good old URL373	ADJ NOUN PUNCT ADJ NOUN PUNCT ADJ NOUN PUNCT NUM ADJ NOUN PUNCT X ADJ ADJ NOUN
RT @USER2267 : I extend my gratitude to all the members of Delhi study group for selecting me as the patron of the organization . URL224 \u2026	X X PUNCT PRON VERB PRON NOUN ADP DET DET NOUN ADP NOUN NOUN NOUN ADP VERB PRON ADP DET NOUN ADP DET NOUN PUNCT X PUNCT
@USER1812 No , I 'm not . It 's definitely not a rapper .	NOUN INTJ PUNCT PRON AUX ADV PUNCT PRON AUX ADV PART DET NOUN PUNCT
